Nad	nad	prep:inst:nwok
pozostałymi	pozostały	adj:pl:inst:m3:pos
obszarami	obszar	subst:pl:inst:m3
dominują	dominować	fin:pl:ter:imperf
układy	układ	subst:pl:nom:m3
wyżowe	wyżowy	adj:pl:nom:m3:pos
.	.	interp
Polska	Polska	subst:sg:nom:f
znajduje	znajdować	fin:sg:ter:imperf
się	się	qub
w	w	prep:loc:nwok
zasięgu	zasięg	subst:sg:loc:m3
klina	klin	subst:sg:gen:m3
wyżowego	wyżowy	adj:sg:gen:m3:pos
,	,	interp
związanego	związany	adj:sg:gen:m3:pos
z	z	prep:inst:nwok
wyżem	wyż	subst:sg:inst:m3
atlantyckim	atlantycki	adj:sg:inst:m3:pos
,	,	interp
ale	ale	conj
nad	nad	prep:inst:nwok
wschodnimi	wschodni	adj:pl:inst:f:pos
dzielnicami	dzielnica	subst:pl:inst:f
kraju	kraj	subst:sg:gen:m3
oddziałuje	oddziaływać	fin:sg:ter:imperf
front	front	subst:sg:nom:m3
atmosferyczny	atmosferyczny	adj:sg:nom:m3:pos
.	.	interp
Napływa	napływać	fin:sg:ter:imperf
dość	dość	qub
ciepłe	ciepły	adj:sg:nom:n:pos
powietrze	powietrze	subst:sg:nom:n
z	z	prep:gen:nwok
zachodu	zachód	subst:sg:gen:m3
.	.	interp
We	w	prep:loc:wok
wschodniej	wschodni	adj:sg:loc:f:pos
części	część	subst:sg:loc:f
kraju	kraj	subst:sg:gen:m3
przeważnie	przeważnie	adv
pochmurno	pochmurno	adv:pos
i	i	conj
miejscami	miejsce	subst:pl:inst:n
deszcz	deszcz	subst:sg:nom:m3
.	.	interp
Na	na	prep:loc
pozostałym	pozostały	adj:sg:loc:m3:pos
obszarze	obszar	subst:sg:loc:m3
po	po	prep:loc
rannych	ranny	adj:pl:loc:f:pos
mgłach	mgła	subst:pl:loc:f
pogodnie	pogodnie	adv:pos
.	.	interp
