Szczególna	szczególny	adj:sg:nom:f:pos
uwaga	uwaga	subst:sg:nom:f
ma	mieć	fin:sg:ter:imperf
być	być	inf:imperf
poświęcona	poświęcić	ppas:sg:nom:f:perf:aff
współdziałaniu	współdziałanie	subst:sg:dat:n
floty	flota	subst:sg:gen:f
i	i	conj
lotnictwa	lotnictwo	subst:sg:gen:n
szturmowego	szturmowy	adj:sg:gen:n:pos
.	.	interp
Samoloty	samolot	subst:pl:nom:m3
mają	mieć	fin:pl:ter:imperf
ćwiczyć	ćwiczyć	inf:imperf
namierzanie	namierzać	ger:sg:acc:n:imperf:aff
okrętów	okręt	subst:pl:gen:m3
podwodnych	podwodny	adj:pl:gen:m3:pos
oraz	oraz	conj
kontrolowanie	kontrolować	ger:sg:acc:n:imperf:aff
wyników	wynik	subst:pl:gen:m3
ostrzału	ostrzał	subst:sg:gen:m3
rakietowego	rakietowy	adj:sg:gen:m3:pos
.	.	interp
Niektóre	niektóry	adj:pl:nom:n:pos
z	z	prep:gen:nwok
tych	ten	adj:pl:gen:n:pos
zadań	zadanie	subst:pl:gen:n
będą	być	bedzie:pl:ter:imperf
przeprowadzone	przeprowadzić	ppas:pl:nom:n:perf:aff
wspólnie	wspólnie	adv:pos
przez	przez	prep:acc:nwok
siły	siła	subst:pl:acc:f
rosyjskie	rosyjski	adj:pl:acc:n:pos
i	i	conj
ukraińskie	ukraiński	adj:pl:acc:n:pos
.	.	interp
Wspólna	wspólny	adj:sg:nom:f:pos
ma	mieć	fin:sg:ter:imperf
być	być	inf:imperf
również	również	qub
ćwiczebna	ćwiczebny	adj:sg:nom:f:pos
operacja	operacja	subst:sg:nom:f
przyjścia	przyjść	ger:sg:gen:n:perf:aff
z	z	prep:inst:nwok
pomocą	pomoc	subst:sg:inst:f
tonącemu	tonąć	pact:sg:dat:m3:imperf:aff
okrętowi	okręt	subst:sg:dat:m3
.	.	interp
