Wprawdzie	wprawdzie	qub
była	być	praet:sg:f:imperf
to	to	pred
oczywista	oczywisty	adj:sg:nom:f:pos
próba	próba	subst:sg:nom:f
usprawiedliwienia	usprawiedliwić	ger:sg:gen:n:perf:aff
agresji	agresja	subst:sg:gen:f
,	,	interp
niemniej	niemniej	qub
potwierdza	potwierdzać	fin:sg:ter:imperf
ona	on	ppron3:sg:nom:f:ter:akc:npraep
przekonanie	przekonanie	subst:sg:acc:n
Rosjan	Rosjanin	subst:pl:gen:m1
o	o	prep:loc
gotowości	gotowość	subst:sg:loc:f
do	do	prep:gen
ustępstw	ustępstwo	subst:pl:gen:n
niektórych	niektóry	adj:pl:gen:m1:pos
polityków	polityk	subst:pl:gen:m1
fińskich	fiński	adj:pl:gen:m1:pos
.	.	interp
Do	do	prep:gen
nich	on	ppron3:pl:gen:m1:ter:akc:praep
należeli	należeć	praet:pl:m1:imperf
niewątpliwie	niewątpliwie	adv:pos
Mannerheim	Mannerheim	subst:sg:nom:m1
,	,	interp
Paasikivi	Paasikivi	subst:sg:nom:m1
i	i	conj
Tanner	Tanner	subst:sg:nom:m1
.	.	interp
Jednakże	jednakże	qub
polityka	polityka	subst:sg:nom:f
zagraniczna	zagraniczny	adj:sg:nom:f:pos
kształtowała	kształtować	praet:sg:f:imperf
się	się	qub
w	w	prep:loc:nwok
Helsinkach	Helsinki	subst:pl:loc:n
pod	pod	prep:inst:nwok
wpływem	wpływ	subst:sg:inst:m3
powszechnego	powszechny	adj:sg:gen:n:pos
przekonania	przekonanie	subst:sg:gen:n
,	,	interp
że	że	comp
przyjęcie	przyjąć	ger:sg:nom:n:perf:aff
radzieckich	radziecki	adj:pl:gen:n:pos
żądań	żądanie	subst:pl:gen:n
doprowadzić	doprowadzić	inf:perf
musi	musieć	fin:sg:ter:imperf
do	do	prep:gen
załamania	załamać	ger:sg:gen:n:perf:aff
się	się	qub
podstaw	podstawa	subst:pl:gen:f
niepodległości	niepodległość	subst:sg:gen:f
Finlandii	Finlandia	subst:sg:gen:f
,	,	interp
a	a	conj
nawet	nawet	qub
do	do	prep:gen
narzucenia	narzucić	ger:sg:gen:n:perf:aff
jej	on	ppron3:sg:dat:f:ter:akc:npraep
systemu	system	subst:sg:gen:m3
komunistycznego	komunistyczny	adj:sg:gen:m3:pos
.	.	interp
