Byłemu	były	adj:sg:dat:m1:pos
prezesowi	prezes	subst:sg:dat:m1
zakładu	zakład	subst:sg:gen:m3
prokuratura	prokuratura	subst:sg:nom:f
zarzuca	zarzucać	fin:sg:ter:imperf
niedopełnienie	dopełnić	ger:sg:acc:n:perf:neg
obowiązków	obowiązek	subst:pl:gen:m3
i	i	conj
spowodowanie	spowodować	ger:sg:acc:n:perf:aff
poprzez	poprzez	prep:acc:nwok
to	to	subst:sg:acc:n
prawie	prawie	qub
8	8	num:pl:gen:m3:congr
mln	milion	brev:npun
zł	złoty	brev:npun
strat	strata	subst:pl:gen:f
.	.	interp
Prokuratorzy	prokurator	subst:pl:nom:m1
podejrzewają	podejrzewać	fin:pl:ter:imperf
Jamrożego	Jamroży	subst:sg:acc:m1
,	,	interp
że	że	comp
akceptował	akceptować	praet:sg:m1:imperf
zakupy	zakup	subst:pl:acc:m3
spółki	spółka	subst:sg:gen:f
-	-	interp
córki	córka	subst:sg:gen:f
PZU	PZU	subst:sg:gen:m3
SA	SA	subst:sg:nom:f
PZU	PZU	subst:sg:gen:m3
Development	Development	subst:sg:gen:m3
,	,	interp
która	który	adj:sg:nom:f:pos
kupowała	kupować	praet:sg:f:imperf
-	-	interp
po	po	prep:loc
sztucznie	sztucznie	adv:pos
zawyżonych	zawyżyć	ppas:pl:loc:f:perf:aff
cenach	cena	subst:pl:loc:f
-	-	interp
grunty	grunt	subst:pl:acc:m3
w	w	prep:loc:nwok
różnych	różny	adj:pl:loc:m3:pos
regionach	region	subst:pl:loc:m3
kraju	kraj	subst:sg:gen:m3
.	.	interp
Różnica	różnica	subst:sg:nom:f
w	w	prep:loc:nwok
cenie	cena	subst:sg:loc:f
trafiała	trafiać	praet:sg:f:imperf
do	do	prep:gen
pośredników	pośrednik	subst:pl:gen:m1
(	(	interp
m.in.	między innymi	brev:pun
aresztowanych	aresztować	ppas:pl:gen:m1:perf:aff
przez	przez	prep:acc:nwok
sąd	sąd	subst:sg:acc:m3
braci	brat	subst:pl:gen:m1
W	W	brev:pun
.	.	interp
)	)	interp
.	.	interp
