Przy	przy	prep:loc
organizacji	organizacja	subst:sg:loc:f
imprezy	impreza	subst:sg:gen:f
masowej	masowy	adj:sg:gen:f:pos
,	,	interp
w	w	prep:loc:nwok
której	który	adj:sg:loc:f:pos
uczestniczy	uczestniczyć	fin:sg:ter:imperf
ok	około	brev:pun
.	.	interp
2	2	num:pl:nom:m3:congr
tys	tysiąc	brev:pun
.	.	interp
osób	osoba	subst:pl:gen:f
,	,	interp
niezbędne	niezbędny	adj:pl:nom:n:pos
są	być	fin:pl:ter:imperf
m.in	między innymi	brev:pun
.	.	interp
zezwolenia	zezwolenie	subst:pl:nom:n
z	z	prep:gen:nwok
Urzędu	urząd	subst:sg:gen:m3
Miasta	miasto	subst:sg:gen:n
,	,	interp
policji	policja	subst:sg:gen:f
i	i	conj
straży	straż	subst:sg:gen:f
pożarnej	pożarny	adj:sg:gen:f:pos
.	.	interp
Jak	jak	adv:pos
nas	my	ppron12:pl:acc:m1:pri
poinformował	poinformować	praet:sg:m1:perf
Wiesław	Wiesław	subst:sg:nom:m1
Kulesza	Kulesza	subst:sg:nom:m1
,	,	interp
zastępca	zastępca	subst:sg:nom:m1
komendanta	komendant	subst:sg:gen:m1
białostockiej	białostocki	adj:sg:gen:f:pos
policji	policja	subst:sg:gen:f
,	,	interp
nie	nie	qub
wpłynął	wpłynąć	praet:sg:m3:perf
do	do	prep:gen
niej	on	ppron3:sg:gen:f:ter:akc:praep
żaden	żaden	adj:sg:nom:m3:pos
wniosek	wniosek	subst:sg:nom:m3
w	w	prep:loc:nwok
sprawie	sprawa	subst:sg:loc:f
koncertu	koncert	subst:sg:gen:m3
.	.	interp
Opinia	opinia	subst:sg:nom:f
policji	policja	subst:sg:gen:f
jest	być	fin:sg:ter:imperf
potrzebna	potrzebny	adj:sg:nom:f:pos
Urzędowi	urząd	subst:sg:dat:m3
Miejskiemu	miejski	adj:sg:dat:m3:pos
do	do	prep:gen
wydania	wydać	ger:sg:gen:n:perf:aff
pozwolenia	pozwolenie	subst:sg:gen:n
na	na	prep:acc
imprezę	impreza	subst:sg:acc:f
masową	masowy	adj:sg:acc:f:pos
.	.	interp
