W	w	prep:loc:nwok
centrum	centrum	subst:sg:loc:n
Kołobrzegu	Kołobrzeg	subst:sg:gen:m3
w	w	prep:loc:nwok
pobliżu	pobliże	subst:sg:loc:n
hotelu	hotel	subst:sg:gen:m3
"	"	interp
Solny	Solny	subst:sg:nom:m3
"	"	interp
miejscowi	miejscowy	adj:pl:nom:m1:pos
chuligani	chuligan	subst:pl:nom:m1
napadli	napaść	praet:pl:m1:perf
trzech	trzy	num:pl:acc:m1:rec
młodych	młody	adj:pl:gen:m1:pos
wrocławian	wrocławianin	subst:pl:gen:m1
.	.	interp
Najbardziej	bardzo	adv:sup
ucierpiał	ucierpieć	praet:sg:m1:perf
Maciej	Maciej	subst:sg:nom:m1
Z	Z	brev:pun
.	.	interp
,	,	interp
który	który	adj:sg:nom:m1:pos
został	zostać	praet:sg:m1:perf
ranny	ranny	adj:sg:nom:m1:pos
w	w	prep:acc:nwok
głowę	głowa	subst:sg:acc:f
.	.	interp
Ponadto	ponadto	qub
napastnicy	napastnik	subst:pl:nom:m1
zabrali	zabrać	praet:pl:m1:perf
mu	on	ppron3:sg:dat:m1:ter:nakc:npraep
zegarek	zegarek	subst:sg:acc:m3
o	o	prep:loc
wartości	wartość	subst:sg:loc:f
260	260	num:pl:gen:m2:congr
złotych	złoty	subst:pl:gen:m2
.	.	interp
Przyjezdni	przyjezdny	subst:pl:nom:m1
musieli	musieć	praet:pl:m1:imperf
skorzystać	skorzystać	inf:perf
z	z	prep:gen:nwok
pomocy	pomoc	subst:sg:gen:f
medycznej	medyczny	adj:sg:gen:f:pos
,	,	interp
gdyż	gdyż	comp
każdego	każdy	adj:sg:acc:m1:pos
z	z	prep:gen:nwok
nich	on	ppron3:pl:gen:m1:ter:akc:praep
"	"	interp
poczęstowano	poczęstować	imps:perf
"	"	interp
gazem	gaz	subst:sg:inst:m3
łzawiącym	łzawić	pact:sg:inst:m3:imperf:aff
.	.	interp
