19-letnia	19-letni	adj:sg:nom:f:pos
mieszkanka	mieszkanka	subst:sg:nom:f
Koszalina	Koszalin	subst:sg:gen:m3
przekonała	przekonać	praet:sg:f:perf
kolegów	kolega	subst:pl:acc:m1
,	,	interp
aby	aby	comp
pomogli	pomóc	praet:pl:m1:perf
jej	on	ppron3:sg:dat:f:ter:akc:npraep
oszukać	oszukać	inf:perf
bank	bank	subst:sg:acc:m3
.	.	interp
Wykorzystując	wykorzystywać	pcon:imperf
sfałszowany	sfałszować	ppas:sg:acc:m3:perf:aff
dowód	dowód	subst:sg:acc:m3
osobisty	osobisty	adj:sg:acc:m3:pos
założyła	założyć	praet:sg:f:perf
konto	konto	subst:sg:acc:n
i	i	conj
wyłudziła	wyłudzić	praet:sg:f:perf
z	z	prep:gen:nwok
banku	bank	subst:sg:gen:m3
5,5	5,5	num:pl:acc:m3:rec
tys	tysiąc	brev:pun
.	.	interp
zł	złoty	brev:npun
.	.	interp
Wstydzę	wstydzić	fin:sg:pri:imperf
się	się	qub
i	i	conj
naprawię	naprawić	fin:sg:pri:perf
szkody	szkoda	subst:pl:acc:f
-	-	interp
płaczliwie	płaczliwie	adv:pos
zapewniała	zapewniać	praet:sg:f:imperf
sąd	sąd	subst:sg:acc:m3
.	.	interp
Przed	przed	prep:inst:nwok
Sądem	sąd	subst:sg:inst:m3
Okręgowym	okręgowy	adj:sg:inst:m3:pos
w	w	prep:loc:nwok
Koszalinie	Koszalin	subst:sg:loc:m3
stanęli	stanąć	praet:pl:m1:perf
wczoraj	wczoraj	adv
oskarżeni	oskarżony	subst:pl:nom:m1
ERROR :		:interp
Klaudia	Klaudia	subst:sg:nom:f
G	G	brev:pun
.	.	interp
(	(	interp
19	19	num:pl:nom:m3:rec
lat	rok	subst:pl:gen:m3
)	)	interp
,	,	interp
Grzegorz	Grzegorz	subst:sg:nom:m1
Sz	Sz	brev:pun
.	.	interp
(	(	interp
24	24	num:pl:nom:m3:congr
lata	rok	subst:pl:nom:m3
)	)	interp
,	,	interp
Bogdan	Bogdan	subst:sg:nom:m1
K	K	brev:pun
.	.	interp
(	(	interp
20-latek	20-latek	subst:sg:nom:m1
)	)	interp
.	.	interp
