O	o	prep:loc
tym	to	subst:sg:loc:n
,	,	interp
że	że	comp
PKP	PKP	subst:sg:nom:n
jest	być	fin:sg:ter:imperf
twórczą	twórczy	adj:sg:inst:f:pos
instytucją	instytucja	subst:sg:inst:f
,	,	interp
przekonała	przekonać	praet:sg:f:perf
mnie	ja	ppron12:sg:acc:m1:pri:akc
informacja	informacja	subst:sg:nom:f
przekazana	przekazać	ppas:sg:nom:f:perf:aff
przez	przez	prep:acc:nwok
głośniki	głośnik	subst:pl:acc:m3
w	w	prep:loc:nwok
pociągu	pociąg	subst:sg:loc:m3
relacji	relacja	subst:sg:gen:f
Warszawa	Warszawa	subst:sg:nom:f
-	-	interp
Berlin	Berlin	subst:sg:nom:m3
.	.	interp
Pan	pan	subst:sg:nom:m1
konduktor	konduktor	subst:sg:nom:m1
poinformował	poinformować	praet:sg:m1:perf
podróżnych	podróżny	subst:pl:acc:m1
,	,	interp
że	że	comp
"	"	interp
pociąg	pociąg	subst:sg:nom:m3
doznał	doznać	praet:sg:m3:perf
opóźnienia	opóźnienie	subst:sg:gen:n
5	5	num:pl:nom:f:rec
minut	minuta	subst:pl:gen:f
"	"	interp
.	.	interp
Kończąc	kończyć	pcon:imperf
życzę	życzyć	fin:sg:pri:imperf
PKP	PKP	subst:pl:dat:n
oraz	oraz	conj
podróżnym	podróżny	subst:pl:dat:m1
,	,	interp
by	by	comp
przerwy	przerwa	subst:pl:nom:f
technologiczne	technologiczny	adj:pl:nom:f:pos
na	na	prep:loc
dworcach	dworzec	subst:pl:loc:m3
zmieniły	zmienić	praet:pl:f:perf
się	się	qub
w	w	prep:acc:nwok
zwykłe	zwykły	adj:sg:acc:n:pos
sprzątanie	sprzątać	ger:sg:acc:n:imperf:aff
,	,	interp
a	a	conj
pociągi	pociąg	subst:pl:nom:m3
już	już	qub
więcej	dużo	adv:com
nie	nie	qub
doznawały	doznawać	praet:pl:m3:imperf
opóźnień	opóźnienie	subst:pl:gen:n
.	.	interp
Handlowcy	handlowiec	subst:pl:nom:m1
wierzą	wierzyć	fin:pl:ter:imperf
,	,	interp
że	że	comp
jeśli	jeśli	comp
taka	taki	adj:sg:nom:f:pos
firma	firma	subst:sg:nom:f
jak	jak	prep:nom
"	"	interp
SPOŁEM	Społem	subst:sg:nom:n
"	"	interp
zapewni	zapewnić	fin:sg:ter:perf
odpowiedni	odpowiedni	adj:sg:acc:m3:pos
poziom	poziom	subst:sg:acc:m3
obsługi	obsługa	subst:sg:gen:f
klientów	klient	subst:pl:gen:m1
,	,	interp
to	to	conj
władze	władza	subst:pl:nom:f
miasta	miasto	subst:sg:gen:n
nie	nie	qub
wpuszczą	wpuścić	fin:pl:ter:perf
zewnętrznego	zewnętrzny	adj:sg:gen:m3:pos
(	(	interp
obcego	obcy	adj:sg:gen:m3:pos
)	)	interp
kapitału	kapitał	subst:sg:gen:m3
.	.	interp
Kapitał	kapitał	subst:sg:nom:m3
obcy	obcy	adj:sg:nom:m3:pos
,	,	interp
dysponując	dysponować	pcon:imperf
praktycznie	praktycznie	adv:pos
nieograniczonymi	nieograniczony	adj:pl:inst:m3:pos
środkami	środek	subst:pl:inst:m3
,	,	interp
znajduje	znajdować	fin:sg:ter:imperf
właściwe	właściwy	adj:pl:acc:f:pos
sobie	siebie	siebie:dat
metody	metoda	subst:pl:acc:f
,	,	interp
aby	aby	comp
osiągnąć	osiągnąć	inf:perf
założone	założyć	ppas:pl:acc:m3:perf:aff
cele	cel	subst:pl:acc:m3
.	.	interp
Prezes	prezes	subst:sg:nom:m1
sulęcińskiej	sulęciński	adj:sg:gen:f:pos
PSS	PSS	subst:sg:gen:f
Katarzyna	Katarzyna	subst:sg:nom:f
Hass	Hass	subst:sg:nom:f
twierdzi	twierdzić	fin:sg:ter:imperf
,	,	interp
że	że	comp
z	z	prep:inst:nwok
taką	taki	adj:sg:inst:f:pos
potęgą	potęga	subst:sg:inst:f
firm	firma	subst:pl:gen:f
handlowych	handlowy	adj:pl:gen:f:pos
żaden	żaden	adj:sg:nom:m3:pos
miejscowy	miejscowy	adj:sg:nom:m3:pos
handel	handel	subst:sg:nom:m3
nie	nie	qub
jest	być	fin:sg:ter:imperf
w	w	prep:loc:nwok
stanie	stan	subst:sg:loc:m3
sobie	siebie	siebie:dat
poradzić	poradzić	inf:perf
.	.	interp
Aby	aby	comp
nie	nie	qub
dać	dać	inf:perf
się	się	qub
zaskoczyć	zaskoczyć	inf:perf
konkurencji	konkurencja	subst:sg:dat:f
,	,	interp
PSS	PSS	subst:sg:nom:f
ciągle	ciągle	adv:pos
inwestuje	inwestować	fin:sg:ter:imperf
i	i	conj
modernizuje	modernizować	fin:sg:ter:imperf
swoje	swój	adj:pl:acc:f:pos
placówki	placówka	subst:pl:acc:f
.	.	interp
Bardzo	bardzo	adv:pos
dobrze	dobrze	adv:pos
rozpoczął	rozpocząć	praet:sg:m3:perf
się	się	qub
także	także	qub
dla	dla	prep:gen
Towarzystwa	towarzystwo	subst:sg:gen:n
1999	1999	adj:sg:nom:m3:pos
rok	rok	subst:sg:nom:m3
.	.	interp
Sulęcińscy	sulęciński	adj:pl:nom:m1:pos
juniorzy	junior	subst:pl:nom:m1
grając	grać	pcon:imperf
wg	według	brev:npun
nowych	nowy	adj:pl:gen:m3:pos
przepisów	przepis	subst:pl:gen:m3
(	(	interp
tie-break	tie-break	subst:sg:nom:m3
do	do	prep:gen
25	25	num:pl:gen:m3:congr
pkt	punkt	brev:pun
.	.	interp
)	)	interp
zwyciężyli	zwyciężyć	praet:pl:m1:perf
w	w	prep:loc:nwok
turnieju	turniej	subst:sg:loc:m3
eliminacyjnym	eliminacyjny	adj:sg:loc:m3:pos
w	w	prep:loc:nwok
Pile	Piła	subst:sg:loc:f
pokonując	pokonywać	pcon:imperf
II	II	adj:sg:acc:m3:pos
zespół	zespół	subst:sg:acc:m3
gospodarzy	gospodarz	subst:pl:gen:m1
,	,	interp
Żaka	Żak	subst:sg:acc:m2
Pyrzyce	Pyrzyce	subst:pl:nom:n
,	,	interp
Mieszka	Mieszko	subst:sg:acc:m2
Połczyn	Połczyn	subst:sg:nom:m3
Zdrój	Zdrój	subst:sg:nom:m3
i	i	conj
awansowali	awansować	praet:pl:m1:perf
do	do	prep:gen
ćwierćfinałów	ćwierćfinał	subst:pl:gen:m3
mistrzostw	mistrzostwa	subst:pl:gen:n
Polski	Polska	subst:sg:gen:f
.	.	interp
Powołano	powołać	imps:perf
również	również	qub
dwie	dwa	num:pl:acc:f:congr
instancje	instancja	subst:pl:acc:f
komisji	komisja	subst:sg:gen:f
dyscyplinarnej	dyscyplinarny	adj:sg:gen:f:pos
,	,	interp
której	który	adj:sg:gen:f:pos
przewodniczącym	przewodniczący	subst:sg:inst:m1
został	zostać	praet:sg:m1:perf
radny	radny	subst:sg:nom:m1
Antoni	Antoni	subst:sg:nom:m1
Kamoda	Kamoda	subst:sg:nom:m1
.	.	interp
Komisja	komisja	subst:sg:nom:f
owa	ów	adj:sg:nom:f:pos
została	zostać	praet:sg:f:perf
powołana	powołać	ppas:sg:nom:f:perf:aff
w	w	prep:loc:nwok
celu	cel	subst:sg:loc:m3
przywoływania	przywoływać	ger:sg:gen:n:imperf:aff
do	do	prep:gen
porządku	porządek	subst:sg:gen:m3
pracowników	pracownik	subst:pl:gen:m1
mianowanych	mianować	ppas:pl:gen:m1:perf:aff
zatrudnionych	zatrudnić	ppas:pl:gen:m1:perf:aff
w	w	prep:loc:nwok
Urzędzie	urząd	subst:sg:loc:m3
Gminy	gmina	subst:sg:gen:f
i	i	conj
podległych	podległy	adj:pl:loc:f:pos
instytucjach	instytucja	subst:pl:loc:f
.	.	interp
Decyzją	decyzja	subst:sg:inst:f
wójta	wójt	subst:sg:gen:m1
Antoniego	Antoni	subst:sg:gen:m1
Polaka	Polak	subst:sg:gen:m1
i	i	conj
Zarządu	zarząd	subst:sg:gen:m3
Gminy	gmina	subst:sg:gen:f
postanowiono	postanowić	imps:perf
w	w	prep:loc:nwok
styczniu	styczeń	subst:sg:loc:m3
przeprowadzić	przeprowadzić	inf:perf
we	w	prep:loc:wok
wszystkich	wszystek	adj:pl:loc:f:pos
wsiach	wieś	subst:pl:loc:f
gminy	gmina	subst:sg:gen:f
wybory	wybory	subst:pl:acc:n
sołtysów	sołtys	subst:pl:gen:m1
.	.	interp
Zapewne	zapewne	qub
czytelnicy	czytelnik	subst:pl:nom:m1
wyciągną	wyciągnąć	fin:pl:ter:perf
słuszny	słuszny	adj:sg:acc:m3:pos
wniosek	wniosek	subst:sg:acc:m3
,	,	interp
że	że	comp
jest	być	fin:sg:ter:imperf
to	to	pred
początek	początek	subst:sg:nom:m3
dyskusji	dyskusja	subst:pl:gen:f
i	i	conj
sporów	spór	subst:pl:gen:m3
z	z	prep:inst:nwok
nowymi	nowy	adj:pl:inst:m3:pos
przepisami	przepis	subst:pl:inst:m3
w	w	prep:loc:nwok
sprawie	sprawa	subst:sg:loc:f
rozliczeń	rozliczenie	subst:pl:gen:n
za	za	prep:acc
energię	energia	subst:sg:acc:f
cieplną	cieplny	adj:sg:acc:f:pos
.	.	interp
Twórcy	twórca	subst:pl:nom:m1
prawa	prawo	subst:sg:gen:n
milczą	milczeć	fin:pl:ter:imperf
,	,	interp
jego	on	ppron3:sg:gen:n:ter:akc:npraep
wykonawcy	wykonawca	subst:pl:nom:m1
protestują	protestować	fin:pl:ter:imperf
,	,	interp
a	a	conj
jak	jak	adv:pos
to	to	qub
w	w	prep:loc:nwok
naszej	nasz	adj:sg:loc:f:pos
polskiej	polski	adj:sg:loc:f:pos
rzeczywistości	rzeczywistość	subst:sg:loc:f
jest	być	fin:sg:ter:imperf
,	,	interp
ten	ten	adj:sg:nom:m1:pos
,	,	interp
którego	który	adj:sg:gen:m1:pos
to	to	subst:sg:nom:n
dotyczy	dotyczyć	fin:sg:ter:imperf
bezpośrednio	bezpośrednio	adv:pos
(	(	interp
czyli	czyli	conj
lokator	lokator	subst:sg:nom:m1
)	)	interp
musi	musieć	fin:sg:ter:imperf
wykazać	wykazać	inf:perf
cierpliwość	cierpliwość	subst:sg:acc:f
.	.	interp
Powołano	powołać	imps:perf
zastępcę	zastępca	subst:sg:acc:m1
Kierownika	kierownik	subst:sg:gen:m1
Urzędu	urząd	subst:sg:gen:m3
Stanu	stan	subst:sg:gen:m3
Cywilnego	cywilny	adj:sg:gen:m3:pos
,	,	interp
którym	który	adj:sg:inst:m1:pos
została	zostać	praet:sg:f:perf
p	pani	brev:pun
.	.	interp
Ewa	Ewa	subst:sg:nom:f
Cichoń	Cichoń	subst:sg:nom:f
.	.	interp
Upoważniono	upoważnić	imps:perf
p	pani	brev:pun
.	.	interp
Marię	Maria	subst:sg:acc:f
Dul	Dul	subst:sg:acc:f
do	do	prep:gen
wydawania	wydawać	ger:sg:gen:n:imperf:aff
decyzji	decyzja	subst:pl:gen:f
administracyjnych	administracyjny	adj:pl:gen:f:pos
w	w	prep:loc:nwok
zakresie	zakres	subst:sg:loc:m3
ustalania	ustalać	ger:sg:gen:n:imperf:aff
prawa	prawo	subst:sg:gen:n
do	do	prep:gen
zasiłków	zasiłek	subst:pl:gen:m3
rodzinnych	rodzinny	adj:pl:gen:m3:pos
i	i	conj
pielęgnacyjnych	pielęgnacyjny	adj:pl:gen:m3:pos
.	.	interp
Przyjęto	przyjąć	imps:perf
również	również	qub
budżet	budżet	subst:sg:acc:m3
na	na	prep:acc
rok	rok	subst:sg:acc:m3
1999	1999	adj:sg:acc:m3:pos
,	,	interp
mimo	mimo	prep:gen
sprzeciwu	sprzeciw	subst:sg:gen:m3
radnych	radny	subst:pl:gen:m1
z	z	prep:gen:nwok
opozycji	opozycja	subst:sg:gen:f
.	.	interp
Grupa	grupa	subst:sg:nom:f
radnych	radny	subst:pl:gen:m1
zaproponowała	zaproponować	praet:sg:f:perf
również	również	qub
podjęcie	podjąć	ger:sg:acc:n:perf:aff
starań	staranie	subst:pl:gen:n
o	o	prep:acc
powołanie	powołać	ger:sg:acc:n:perf:aff
w	w	prep:loc:nwok
Sulęcinie	Sulęcin	subst:sg:loc:m3
filii	filia	subst:sg:gen:f
Wyższej	wysoki	adj:sg:gen:f:com
Szkoły	szkoła	subst:sg:gen:f
Zawodowej	zawodowy	adj:sg:gen:f:pos
.	.	interp
Do	do	prep:gen
sukcesów	sukces	subst:pl:gen:m3
należało	należeć	praet:sg:n:imperf
zorganizowanie	zorganizować	ger:sg:nom:n:perf:aff
w	w	prep:loc:nwok
Sulęcinie	Sulęcin	subst:sg:loc:m3
turnieju	turniej	subst:sg:gen:m3
z	z	prep:inst:nwok
udziałem	udział	subst:sg:inst:m3
czołowych	czołowy	adj:pl:gen:m3:pos
zespołów	zespół	subst:pl:gen:m3
polskiej	polski	adj:sg:gen:f:pos
ekstraklasy	ekstraklasa	subst:sg:gen:f
bardzo	bardzo	adv:pos
wysoko	wysoko	adv:pos
ocenionego	ocenić	ppas:sg:gen:m3:perf:aff
przez	przez	prep:acc:nwok
trenerów	trener	subst:pl:acc:m1
,	,	interp
działaczy	działacz	subst:pl:acc:m1
i	i	conj
samych	sam	adj:pl:acc:m1:pos
zawodników	zawodnik	subst:pl:acc:m1
oraz	oraz	conj
zrealizowanie	zrealizować	ger:sg:nom:n:perf:aff
przez	przez	prep:acc:nwok
występujący	występować	pact:pl:acc:m1:imperf:aff
w	w	prep:loc:nwok
III	III	adj:sg:loc:f:pos
lidze	liga	subst:sg:loc:f
mężczyzn	mężczyzna	subst:pl:acc:m1
zadań	zadanie	subst:pl:gen:n
stawianych	stawiać	ppas:pl:gen:n:imperf:aff
przed	przed	prep:inst:nwok
pierwszą	pierwszy	adj:sg:inst:f:pos
rundą	runda	subst:sg:inst:f
sezonu	sezon	subst:sg:gen:m3
1998	1998	num:pl:nom:m3:rec
/	/	interp
1999	1999	num:pl:nom:m3:rec
.	.	interp
We	w	prep:loc:wok
wrześniowym	wrześniowy	adj:sg:loc:m3:pos
turnieju	turniej	subst:sg:loc:m3
zagrały	zagrać	praet:pl:m3:perf
zespoły	zespół	subst:pl:nom:m3
Legii	legia	subst:sg:gen:f
Warszawa	Warszawa	subst:sg:nom:f
,	,	interp
Stali	stal	subst:sg:gen:f
Nysa	Nysa	subst:sg:nom:f
,	,	interp
Jastrzębie	Jastrzębie	subst:sg:nom:n
Borynii	Borynia	subst:sg:gen:f
oraz	oraz	conj
Stilonu	Stilon	subst:sg:gen:m3
Gorzów	Gorzów	subst:sg:nom:m3
.	.	interp
Po	po	prep:loc
trzech	trzy	num:pl:loc:m3:congr
dniach	dzień	subst:pl:loc:m3
emocjonujących	emocjonować	pact:pl:gen:n:imperf:aff
spotkań	spotkanie	subst:pl:gen:n
zwycięzcami	zwycięzca	subst:pl:inst:m1
turnieju	turniej	subst:sg:gen:m3
zostali	zostać	praet:pl:m1:perf
siatkarze	siatkarz	subst:pl:nom:m1
z	z	prep:gen:nwok
Gorzowa	Gorzów	subst:sg:gen:m3
.	.	interp
Komisje	komisja	subst:pl:nom:f
Rady	rada	subst:sg:gen:f
już	już	qub
pracują	pracować	fin:pl:ter:imperf
.	.	interp
Ukonstytuowały	ukonstytuować	praet:pl:f:perf
się	się	qub
już	już	qub
wszystkie	wszystek	adj:pl:nom:f:pos
komisje	komisja	subst:pl:nom:f
działające	działać	pact:pl:nom:f:imperf:aff
przy	przy	prep:loc
Radzie	rada	subst:sg:loc:f
Gminy	gmina	subst:sg:gen:f
i	i	conj
od	od	prep:gen:nwok
razu	raz	subst:sg:gen:m3
zabrały	zabrać	praet:pl:f:perf
się	się	qub
do	do	prep:gen
roboty	robota	subst:sg:gen:f
nad	nad	prep:inst:nwok
sporządzeniem	sporządzić	ger:sg:inst:n:perf:aff
planu	plan	subst:sg:gen:m3
działania	działać	ger:sg:gen:n:imperf:aff
na	na	prep:acc
rok	rok	subst:sg:acc:m3
1999	1999	adj:sg:acc:m3:pos
.	.	interp
Wcześniej	wcześnie	adv:com
jednak	jednak	conj
na	na	prep:acc
tapetę	tapeta	subst:sg:acc:f
wzięły	wziąć	praet:pl:f:perf
przedstawiony	przedstawić	ppas:sg:acc:m3:perf:aff
przez	przez	prep:acc:nwok
Zarząd	zarząd	subst:sg:acc:m3
Gminy	gmina	subst:sg:gen:f
projekt	projekt	subst:sg:acc:m3
budżetu	budżet	subst:sg:gen:m3
.	.	interp
