W	w	prep:acc:nwok
środę	środa	subst:sg:acc:f
ze	z	prep:gen:wok
Szpitala	szpital	subst:sg:gen:m3
Ginekologiczno	ginekologiczny	adja
-	-	interp
Położniczego	położniczy	adj:sg:gen:m3:pos
w	w	prep:loc:nwok
Opolu	Opole	subst:sg:loc:n
wypisywano	wypisywać	imps:imperf
11	11	num:pl:acc:m2:rec
noworodków	noworodek	subst:pl:gen:m2
.	.	interp
Każde	każdy	adj:sg:nom:n:pos
dziecko	dziecko	subst:sg:nom:n
miało	mieć	praet:sg:n:imperf
na	na	prep:loc
rączkach	rączka	subst:pl:loc:f
identyfikatory	identyfikator	subst:pl:acc:m3
z	z	prep:inst:nwok
nazwiskiem	nazwisko	subst:sg:inst:n
,	,	interp
oznaczeniem	oznaczenie	subst:sg:inst:n
płci	płeć	subst:sg:gen:f
i	i	conj
godziną	godzina	subst:sg:inst:f
przyjścia	przyjść	ger:sg:gen:n:perf:aff
na	na	prep:acc
świat	świat	subst:sg:acc:m3
.	.	interp
Zakłada	zakładać	fin:sg:ter:imperf
się	się	qub
je	on	ppron3:pl:acc:m3:ter:akc:npraep
jeszcze	jeszcze	qub
na	na	prep:loc
sali	sala	subst:sg:loc:f
porodowej	porodowy	adj:sg:loc:f:pos
,	,	interp
zaraz	zaraz	qub
po	po	prep:loc
okazaniu	okazać	ger:sg:loc:n:perf:aff
noworodka	noworodek	subst:sg:gen:m2
matce	matka	subst:sg:dat:f
.	.	interp
