Wszystkie	wszystek	adj:pl:nom:m3:pos
pieniądze	pieniądz	subst:pl:nom:m3
z	z	prep:gen:nwok
aukcji	aukcja	subst:pl:gen:f
zostaną	zostać	fin:pl:ter:perf
przeznaczone	przeznaczyć	ppas:pl:nom:m3:perf:aff
na	na	prep:acc
budowę	budowa	subst:sg:acc:f
nowego	nowy	adj:sg:gen:m3:pos
oddziału	oddział	subst:sg:gen:m3
przeszczepowego	przeszczepowy	adj:sg:gen:m3:pos
dla	dla	prep:gen
dzieci	dziecko	subst:pl:gen:n
z	z	prep:inst:nwok
białaczką	białaczka	subst:sg:inst:f
przy	przy	prep:loc
szpitalu	szpital	subst:sg:loc:m3
w	w	prep:loc:nwok
Poznaniu	Poznań	subst:sg:loc:m3
.	.	interp
W	w	prep:loc:nwok
tej	ten	adj:sg:loc:f:pos
chwili	chwila	subst:sg:loc:f
szpital	szpital	subst:sg:nom:m3
ma	mieć	fin:sg:ter:imperf
dwa	dwa	num:pl:acc:n:congr
stanowiska	stanowisko	subst:pl:acc:n
umożliwiające	umożliwiać	pact:pl:acc:n:imperf:aff
przeszczep	przeszczep	subst:sg:acc:m3
,	,	interp
gdzie	gdzie	adv
wykonuje	wykonywać	fin:sg:ter:imperf
połowę	połowa	subst:sg:acc:f
wszystkich	wszystek	adj:pl:gen:f:pos
operacji	operacja	subst:pl:gen:f
przeprowadzanych	przeprowadzać	ppas:pl:gen:f:imperf:aff
w	w	prep:loc:nwok
Polsce	Polska	subst:sg:loc:f
,	,	interp
a	a	conj
to	to	pred
tylko	tylko	qub
ułamek	ułamek	subst:sg:nom:m3
zapotrzebowania	zapotrzebowanie	subst:sg:gen:n
.	.	interp
Dzięki	dzięki	prep:dat
nowemu	nowy	adj:sg:dat:m3:pos
oddziałowi	oddział	subst:sg:dat:m3
szpital	szpital	subst:sg:nom:m3
będzie	być	bedzie:sg:ter:imperf
mógł	móc	praet:sg:m3:imperf:nagl
uratować	uratować	inf:perf
znacznie	znacznie	adv:pos
więcej	więcej	num:pl:acc:n:rec
dzieci	dziecko	subst:pl:gen:n
chorych	chory	adj:pl:gen:n:pos
na	na	prep:acc
białaczkę	białaczka	subst:sg:acc:f
.	.	interp
