Sprawą	sprawa	subst:sg:inst:f
zajęła	zająć	praet:sg:f:perf
się	się	qub
już	już	qub
prokuratura	prokuratura	subst:sg:nom:f
w	w	prep:loc:nwok
Gryficach	Gryfice	subst:pl:loc:n
.	.	interp
W	w	prep:loc:nwok
trakcie	trakt	subst:sg:loc:m3
kontroli	kontrola	subst:sg:gen:f
zasadności	zasadność	subst:sg:gen:f
wystawiania	wystawiać	ger:sg:gen:n:imperf:aff
recept	recepta	subst:pl:gen:f
refundowanych	refundować	ppas:pl:gen:f:imperf:aff
przez	przez	prep:acc:nwok
Zachodniopomorską	zachodniopomorski	adj:sg:acc:f:pos
Regionalną	regionalny	adj:sg:acc:f:pos
Kasę	kasa	subst:sg:acc:f
Chorych	chory	subst:pl:gen:m1
okazało	okazać	praet:sg:n:perf
się	się	qub
,	,	interp
że	że	comp
dwaj	dwa	num:pl:nom:m1:congr
lekarze	lekarz	subst:pl:nom:m1
z	z	prep:gen:nwok
Trzebiatowa	Trzebiatów	subst:sg:gen:m3
wystawili	wystawić	praet:pl:m1:perf
recepty	recepta	subst:pl:acc:f
pacjentom	pacjent	subst:pl:dat:m1
nie	nie	qub
leczącym	leczyć	pact:pl:dat:m1:imperf:aff
się	się	qub
hormonalnie	hormonalnie	adv:pos
.	.	interp
W	w	prep:loc:nwok
kilkudziesięciu	kilkadziesiąt	num:pl:loc:m3:congr
innych	inny	adj:pl:loc:m3:pos
przypadkach	przypadek	subst:pl:loc:m3
recepty	recepta	subst:pl:nom:f
były	być	praet:pl:f:imperf
wystawiane	wystawiać	ppas:pl:nom:f:imperf:aff
,	,	interp
ale	ale	conj
w	w	prep:loc:nwok
przychodni	przychodnia	subst:sg:loc:f
nie	nie	qub
ma	mieć	fin:sg:ter:imperf
żadnej	żaden	adj:sg:gen:f:pos
dokumentacji	dokumentacja	subst:sg:gen:f
potwierdzającej	potwierdzać	pact:sg:gen:f:imperf:aff
ich	on	ppron3:pl:gen:f:ter:akc:npraep
wypisanie	wypisać	ger:sg:acc:n:perf:aff
.	.	interp
