Indyjski	indyjski	adj:sg:nom:m1:pos
minister	minister	subst:sg:nom:m1
spraw	sprawa	subst:pl:gen:f
zagranicznych	zagraniczny	adj:pl:gen:f:pos
Jaswant	Jaswant	subst:sg:nom:m1
Singh	Singh	subst:sg:nom:m1
powiedział	powiedzieć	praet:sg:m1:perf
we	w	prep:acc:wok
wtorek	wtorek	subst:sg:acc:m3
,	,	interp
że	że	comp
zwolnienie	zwolnić	ger:sg:nom:n:perf:aff
dzieci	dziecko	subst:pl:gen:n
i	i	conj
kobiet	kobieta	subst:pl:gen:f
było	być	praet:sg:n:imperf
jednym	jeden	adj:sg:inst:m3:pos
z	z	prep:gen:nwok
pierwszych	pierwszy	adj:pl:gen:m3:pos
warunków	warunek	subst:pl:gen:m3
,	,	interp
które	który	adj:pl:acc:m3:pos
postawili	postawić	praet:pl:m1:perf
w	w	prep:loc:nwok
rozmowie	rozmowa	subst:sg:loc:f
z	z	prep:inst:nwok
porywaczami	porywacz	subst:pl:inst:m1
indyjscy	indyjski	adj:pl:nom:m1:pos
negocjatorzy	negocjator	subst:pl:nom:m1
.	.	interp
Terroryści	terrorysta	subst:pl:nom:m1
zdecydowanie	zdecydowanie	adv:pos
jednak	jednak	conj
odrzucili	odrzucić	praet:pl:m1:perf
ten	ten	adj:sg:acc:m3:pos
postulat	postulat	subst:sg:acc:m3
.	.	interp
Indyjskim	indyjski	adj:pl:dat:m1:pos
mechanikom	mechanik	subst:pl:dat:m1
przysłanym	przysłać	ppas:pl:dat:m1:perf:aff
z	z	prep:gen:nwok
Delhi	Delhi	subst:sg:gen:n
nie	nie	qub
udało	udać	praet:sg:n:perf
się	się	qub
uruchomić	uruchomić	inf:perf
silnika	silnik	subst:sg:gen:m3
pomocniczego	pomocniczy	adj:sg:gen:m3:pos
porwanego	porwać	ppas:sg:gen:m3:perf:aff
samolotu	samolot	subst:sg:gen:m3
indyjskich	indyjski	adj:pl:gen:f:pos
linii	linia	subst:pl:gen:f
.	.	interp
