Funkcjonariuszom	funkcjonariusz	subst:pl:dat:m1
udało	udać	praet:sg:n:perf
się	się	qub
odzyskać	odzyskać	inf:perf
część	część	subst:sg:acc:f
krzyży	krzyż	subst:pl:gen:m3
oraz	oraz	conj
ustalić	ustalić	inf:perf
personalia	personalia	subst:pl:acc:n
dwóch	dwa	num:pl:gen:m1:congr
pozostałych	pozostały	adj:pl:gen:m1:pos
sprawców	sprawca	subst:pl:gen:m1
,	,	interp
którzy	który	adj:pl:nom:m1:pos
brali	brać	praet:pl:m1:imperf
udział	udział	subst:sg:acc:m3
w	w	prep:loc:nwok
kradzieży	kradzież	subst:sg:loc:f
i	i	conj
dewastacji	dewastacja	subst:sg:loc:f
.	.	interp
Jak	jak	adv:pos
już	już	qub
informowali	informować	praet:pl:m1:imperf
śmy	być	aglt:pl:pri:imperf:nwok
,	,	interp
sprawcy	sprawca	subst:pl:nom:m1
,	,	interp
którzy	który	adj:pl:nom:m1:pos
pojawili	pojawić	praet:pl:m1:perf
się	się	qub
na	na	prep:loc
barcińskim	barciński	adj:sg:loc:m3:pos
cmentarzu	cmentarz	subst:sg:loc:m3
,	,	interp
uszkodzili	uszkodzić	praet:pl:m1:perf
około	około	qub
90	90	num:pl:acc:f:rec
płyt	płyta	subst:pl:gen:f
nagrobnych	nagrobny	adj:pl:gen:f:pos
odrywając	odrywać	pcon:imperf
z	z	prep:gen:nwok
nich	on	ppron3:pl:gen:f:ter:akc:praep
ozdobne	ozdobny	adj:pl:acc:f:pos
litery	litera	subst:pl:acc:f
wykonane	wykonać	ppas:pl:acc:f:perf:aff
z	z	prep:gen:nwok
mosiądzu	mosiądz	subst:sg:gen:m3
oraz	oraz	conj
wyrywając	wyrywać	pcon:imperf
z	z	prep:gen:nwok
krzyży	krzyż	subst:pl:gen:m3
pasyjki	pasyjka	subst:pl:acc:f
.	.	interp
