Boeing	Boeing	subst:sg:nom:m2
2707	2707	num:pl:nom:m3:rec
miał	mieć	praet:sg:m2:imperf
być	być	inf:imperf
pierwszym	pierwszy	adj:sg:inst:m3:pos
amerykańskim	amerykański	adj:sg:inst:m3:pos
ponaddźwiękowym	ponaddźwiękowy	adj:sg:inst:m3:pos
samolotem	samolot	subst:sg:inst:m3
pasażerskim	pasażerski	adj:sg:inst:m3:pos
.	.	interp
Miał	mieć	praet:sg:m2:imperf
osiągać	osiągać	inf:imperf
prędkość	prędkość	subst:sg:acc:f
3	3	num:pl:gen:m2:congr
Ma	mach	brev:npun
,	,	interp
zabierać	zabierać	inf:imperf
do	do	prep:gen
300	300	num:pl:gen:m1:congr
pasażerów	pasażer	subst:pl:gen:m1
i	i	conj
być	być	inf:imperf
w	w	prep:loc:nwok
stanie	stan	subst:sg:loc:m3
pokonać	pokonać	inf:perf
Atlantyk	Atlantyk	subst:sg:acc:m3
.	.	interp
Projekt	projekt	subst:sg:nom:m3
ten	ten	adj:sg:nom:m3:pos
został	zostać	praet:sg:m3:perf
anulowany	anulować	ppas:sg:nom:m3:perf:aff
w	w	prep:loc:nwok
1971	1971	adj:sg:loc:m3:pos
roku	rok	subst:sg:loc:m3
z	z	prep:gen:nwok
powodu	powód	subst:sg:gen:m3
trudności	trudność	subst:pl:gen:f
w	w	prep:loc:nwok
realizacji	realizacja	subst:sg:loc:f
postawionych	postawić	ppas:pl:gen:n:perf:aff
przed	przed	prep:inst:nwok
nim	on	ppron3:sg:inst:m3:ter:akc:praep
wymagań	wymaganie	subst:pl:gen:n
.	.	interp
