Zdaniem	zdanie	subst:sg:inst:n
projektantów	projektant	subst:pl:gen:m1
(	(	interp
wolą	woleć	fin:pl:ter:imperf
być	być	inf:imperf
nazywani	nazywać	ppas:pl:nom:m1:imperf:aff
designerami	designer	subst:pl:inst:m1
)	)	interp
pozwalamy	pozwalać	fin:pl:pri:imperf
sobie	siebie	siebie:dat
na	na	prep:acc
odrobinę	odrobina	subst:sg:acc:f
swobody	swoboda	subst:sg:gen:f
i	i	conj
puszczamy	puszczać	fin:pl:pri:imperf
wodze	wodza	subst:pl:acc:f
wyobraźni	wyobraźnia	subst:sg:gen:f
tylko	tylko	qub
w	w	prep:loc:nwok
kuchni	kuchnia	subst:sg:loc:f
.	.	interp
Dziwnym	dziwny	adj:sg:inst:m3:pos
trafem	traf	subst:sg:inst:m3
to	to	qub
właśnie	właśnie	qub
producenci	producent	subst:pl:nom:m1
mebli	mebel	subst:pl:gen:m3
kuchennych	kuchenny	adj:pl:gen:m3:pos
są	być	fin:pl:ter:imperf
prekursorami	prekursor	subst:pl:inst:m1
nowych	nowy	adj:pl:gen:f:pos
tendencji	tendencja	subst:pl:gen:f
w	w	prep:loc:nwok
meblarskim	meblarski	adj:sg:loc:n:pos
wzornictwie	wzornictwo	subst:sg:loc:n
.	.	interp
Od	od	prep:gen:nwok
wczoraj	wczoraj	subst:sg:gen:n
na	na	prep:loc
meblowej	meblowy	adj:sg:loc:f:pos
wystawie	wystawa	subst:sg:loc:f
można	można	pred
oglądać	oglądać	inf:imperf
dokonania	dokonanie	subst:pl:acc:n
700	700	num:pl:gen:m1:congr
wystawców	wystawca	subst:pl:gen:m1
z	z	prep:gen:nwok
Polski	Polska	subst:sg:gen:f
oraz	oraz	conj
22	22	num:pl:gen:m3:congr
krajów	kraj	subst:pl:gen:m3
Europy	Europa	subst:sg:gen:f
i	i	conj
świata	świat	subst:sg:gen:m3
.	.	interp
