W	w	prep:loc:nwok
Łowiczu	Łowicz	subst:sg:loc:m3
i	i	conj
Rawie	Rawa	subst:sg:loc:f
Mazowieckiej	Mazowiecki	adj:sg:loc:f:pos
trwają	trwać	fin:pl:ter:imperf
przygotowania	przygotowanie	subst:pl:nom:n
-	-	interp
poinformowała	poinformować	praet:sg:f:perf
nas	my	ppron12:pl:acc:m1:pri
Zenona	Zenona	subst:sg:nom:f
Czarnecka	Czarnecka	subst:sg:nom:f
,	,	interp
wiceprzewodnicząca	wiceprzewodnicząca	subst:sg:nom:f
Ogólnopolskiego	ogólnopolski	adj:sg:gen:m3:pos
Związku	związek	subst:sg:gen:m3
Zawodowego	zawodowy	adj:sg:gen:m3:pos
Pielęgniarek	pielęgniarka	subst:pl:gen:f
i	i	conj
Położnych	położna	subst:pl:gen:f
Regionu	region	subst:sg:gen:m3
Łódzkiego	łódzki	adj:sg:gen:m3:pos
.	.	interp
Praca	praca	subst:sg:nom:f
w	w	prep:loc:nwok
okupowanych	okupować	ppas:pl:loc:m3:imperf:aff
szpitalach	szpital	subst:pl:loc:m3
przebiega	przebiegać	fin:sg:ter:imperf
normalnie	normalnie	adv:pos
.	.	interp
Siostry	siostra	subst:pl:nom:f
wykonują	wykonywać	fin:pl:ter:imperf
swoje	swój	adj:pl:acc:m3:pos
obowiązki	obowiązek	subst:pl:acc:m3
,	,	interp
a	a	conj
po	po	prep:loc
pracy	praca	subst:sg:loc:f
przechodzą	przechodzić	fin:pl:ter:imperf
do	do	prep:gen
specjalnie	specjalnie	adv:pos
wydzielonego	wydzielić	ppas:sg:gen:n:perf:aff
przez	przez	prep:acc:nwok
dyrekcję	dyrekcja	subst:sg:acc:f
pomieszczenia	pomieszczenie	subst:sg:gen:n
,	,	interp
w	w	prep:loc:nwok
którym	który	adj:sg:loc:n:pos
będą	być	bedzie:pl:ter:imperf
przebywać	przebywać	inf:imperf
przez	przez	prep:acc:nwok
całą	cały	adj:sg:acc:f:pos
dobę	doba	subst:sg:acc:f
(	(	interp
na	na	prep:acc
zmiany	zmiana	subst:pl:acc:f
)	)	interp
.	.	interp
