Wypłacenia	wypłacić	ger:sg:gen:n:perf:aff
szkołom	szkoła	subst:pl:dat:f
wyższym	wysoki	adj:pl:dat:f:com
150	150	num:pl:gen:m3:congr
mln	milion	brev:npun
zł	złoty	brev:npun
,	,	interp
których	który	adj:pl:gen:m3:pos
brakuje	brakować	fin:sg:ter:imperf
do	do	prep:gen
wykonania	wykonać	ger:sg:gen:n:perf:aff
tegorocznego	tegoroczny	adj:sg:gen:m3:pos
budżetu	budżet	subst:sg:gen:m3
,	,	interp
żądają	żądać	fin:pl:ter:imperf
rektorzy	rektor	subst:pl:nom:m1
szkół	szkoła	subst:pl:gen:f
wyższych	wysoki	adj:pl:gen:f:com
,	,	interp
kierując	kierować	pcon:imperf
list	list	subst:sg:acc:m3
w	w	prep:loc:nwok
tej	ten	adj:sg:loc:f:pos
sprawie	sprawa	subst:sg:loc:f
do	do	prep:gen
premiera	premier	subst:sg:gen:m1
Jerzego	Jerzy	subst:sg:gen:m1
Buzka	Buzek	subst:sg:gen:m1
.	.	interp
Obradujące	obradować	pact:sg:nom:n:imperf:aff
w	w	prep:acc:nwok
sobotę	sobota	subst:sg:acc:f
prezydium	prezydium	subst:sg:nom:n
Konferencji	konferencja	subst:sg:gen:f
Rektorów	rektor	subst:pl:gen:m1
Akademickich	akademicki	adj:pl:gen:m1:pos
Szkół	szkoła	subst:pl:gen:f
Polskich	polski	adj:pl:gen:f:pos
poparło	poprzeć	praet:sg:n:perf
starania	staranie	subst:pl:acc:n
ministra	minister	subst:sg:gen:m1
edukacji	edukacja	subst:sg:gen:f
Edmunda	Edmund	subst:sg:gen:m1
Wittbrodta	Wittbrodt	subst:sg:gen:m1
o	o	prep:acc
skierowanie	skierować	ger:sg:acc:n:perf:aff
pod	pod	prep:acc:nwok
obrady	obrady	subst:pl:acc:n
rządu	rząd	subst:sg:gen:m3
projektu	projekt	subst:sg:gen:m3
ustawy	ustawa	subst:sg:gen:f
Prawo	prawo	subst:sg:nom:n
o	o	prep:loc
szkolnictwie	szkolnictwo	subst:sg:loc:n
wyższym	wysoki	adj:sg:loc:n:com
.	.	interp
