W	w	prep:loc:nwok
Łebie	Łeba	subst:sg:loc:f
na	na	prep:loc
terenie	teren	subst:sg:loc:m3
punktu	punkt	subst:sg:gen:m3
obserwacyjnego	obserwacyjny	adj:sg:gen:m3:pos
Marynarki	marynarka	subst:sg:gen:f
Wojennej	wojenny	adj:sg:gen:f:pos
odnaleziono	odnaleźć	imps:perf
fragment	fragment	subst:sg:acc:m3
tajemniczej	tajemniczy	adj:sg:gen:f:pos
lufy	lufa	subst:sg:gen:f
.	.	interp
Z	z	prep:gen:nwok
dokumentów	dokument	subst:pl:gen:m3
i	i	conj
relacji	relacja	subst:pl:gen:f
świadków	świadek	subst:pl:gen:m1
wynika	wynikać	fin:sg:ter:imperf
,	,	interp
że	że	comp
w	w	prep:loc:nwok
tym	ten	adj:sg:loc:n:pos
miejscu	miejsce	subst:sg:loc:n
w	w	prep:loc:nwok
czasie	czas	subst:sg:loc:m3
II	II	adj:sg:gen:f:pos
wojny	wojna	subst:sg:gen:f
światowej	światowy	adj:sg:gen:f:pos
znajdował	znajdować	praet:sg:m3:imperf
się	się	qub
tajny	tajny	adj:sg:nom:m3:pos
niemiecki	niemiecki	adj:sg:nom:m3:pos
poligon	poligon	subst:sg:nom:m3
rakietowy	rakietowy	adj:sg:nom:m3:pos
,	,	interp
na	na	prep:loc
którym	który	adj:sg:loc:m3:pos
dokonywano	dokonywać	imps:imperf
prób	próba	subst:pl:gen:f
pod	pod	prep:inst:nwok
okiem	oko	subst:sg:inst:n
Wernera	Werner	subst:sg:gen:m1
von	von	subst:sg:gen:m1
Brauna	Braun	subst:sg:gen:m1
,	,	interp
hitlerowskiego	hitlerowski	adj:sg:gen:m1:pos
speca	spec	subst:sg:gen:m1
od	od	prep:gen:nwok
rakiet	rakieta	subst:pl:gen:f
"	"	interp
V	V	subst:sg:nom:n
"	"	interp
.	.	interp
Według	według	prep:gen
Leszka	Leszek	subst:sg:gen:m1
Kotarskiego	Kotarski	subst:sg:gen:m1
z	z	prep:gen:nwok
Lęborskiego	lęborski	adj:sg:gen:n:pos
Bractwa	bractwo	subst:sg:gen:n
Historycznego	historyczny	adj:sg:gen:n:pos
,	,	interp
który	który	adj:sg:nom:m1:pos
od	od	prep:gen:nwok
ponad	ponad	qub
trzech	trzy	num:pl:gen:m3:congr
lat	rok	subst:pl:gen:m3
zajmuje	zajmować	fin:sg:ter:imperf
się	się	qub
wyjaśnianiem	wyjaśniać	ger:sg:inst:n:imperf:aff
wojennych	wojenny	adj:pl:gen:f:pos
tajemnic	tajemnica	subst:pl:gen:f
poligonu	poligon	subst:sg:gen:m3
,	,	interp
na	na	prep:loc
terenie	teren	subst:sg:loc:m3
dzisiejszego	dzisiejszy	adj:sg:gen:m3:pos
wojskowego	wojskowy	adj:sg:gen:m3:pos
ośrodka	ośrodek	subst:sg:gen:m3
wypoczynkowego	wypoczynkowy	adj:sg:gen:m3:pos
i	i	conj
punktu	punkt	subst:sg:gen:m3
obserwacyjnego	obserwacyjny	adj:sg:gen:m3:pos
Marynarki	marynarka	subst:sg:gen:f
Wojennej	wojenny	adj:sg:gen:f:pos
znajdowały	znajdować	praet:pl:f:imperf
się	się	qub
niemieckie	niemiecki	adj:pl:nom:f:pos
wyrzutnie	wyrzutnia	subst:pl:nom:f
rakiet	rakieta	subst:pl:gen:f
Rheintochter	Rheintochter	subst:sg:nom:f
i	i	conj
Rheinbote	Rheinbote	subst:sg:nom:f
.	.	interp
