Uduszenie	uduszenie	subst:sg:nom:n
było	być	praet:sg:n:imperf
prawdopodobną	prawdopodobny	adj:sg:inst:f:pos
przyczyną	przyczyna	subst:sg:inst:f
śmierci	śmierć	subst:sg:gen:f
5-letniej	5-letni	adj:sg:gen:f:pos
Ewy	Ewa	subst:sg:gen:f
,	,	interp
która	który	adj:sg:nom:f:pos
w	w	prep:acc:nwok
sobotę	sobota	subst:sg:acc:f
zaginęła	zaginąć	praet:sg:f:perf
w	w	prep:loc:nwok
Ustrzykach	Ustrzyki	subst:pl:loc:n
Dolnych	Dolny	subst:pl:loc:n
(	(	interp
Podkarpackie	Podkarpackie	subst:sg:nom:n
)	)	interp
.	.	interp
Do	do	prep:gen
zbrodni	zbrodnia	subst:sg:gen:f
przyznał	przyznać	praet:sg:m1:perf
się	się	qub
22-letni	22-letni	adj:sg:nom:m1:pos
mieszkaniec	mieszkaniec	subst:sg:nom:m1
tego	ten	adj:sg:gen:n:pos
miasta	miasto	subst:sg:gen:n
.	.	interp
Matka	matka	subst:sg:nom:f
po	po	prep:acc
raz	raz	subst:sg:acc:m3
ostatni	ostatni	adj:sg:acc:m3:pos
widziała	widzieć	praet:sg:f:imperf
dziecko	dziecko	subst:sg:acc:n
ok	około	brev:pun
.	.	interp
godz	godzina	brev:pun
.	.	interp
16	16	adj:sg:gen:f:pos
.	.	interp
30	30	num:pl:nom:f:rec
.	.	interp
dziewczynka	dziewczynka	subst:sg:nom:f
bawiła	bawić	praet:sg:f:imperf
się	się	qub
na	na	prep:loc
podwórku	podwórko	subst:sg:loc:n
przed	przed	prep:inst:nwok
blokiem	blok	subst:sg:inst:m3
.	.	interp
Kiedy	kiedy	adv
dziecko	dziecko	subst:sg:nom:n
nie	nie	qub
wróciło	wrócić	praet:sg:n:perf
do	do	prep:gen
domu	dom	subst:sg:gen:m3
,	,	interp
rodzina	rodzina	subst:sg:nom:f
samodzielnie	samodzielnie	adv:pos
rozpoczęła	rozpocząć	praet:sg:f:perf
poszukiwania	poszukiwanie	subst:pl:acc:n
.	.	interp
