Na	na	prep:loc
początku	początek	subst:sg:loc:m3
mojej	mój	adj:sg:gen:f:pos
blogowej	blogowy	adj:sg:gen:f:pos
przygody	przygoda	subst:sg:gen:f
z	z	prep:inst:nwok
Redakcją	redakcja	subst:sg:inst:f
zamieściła	zamieścić	praet:sg:f:perf
m	być	aglt:sg:pri:imperf:nwok
dość	dość	qub
obszerny	obszerny	adj:sg:acc:m3:pos
tekst	tekst	subst:sg:acc:m3
na	na	prep:acc
temat	temat	subst:sg:acc:m3
ZUS	ZUS	subst:sg:gen:m3
.	.	interp
Pisała	pisać	praet:sg:f:imperf
m	być	aglt:sg:pri:imperf:nwok
,	,	interp
jak	jak	adv:pos
zwykli	zwykły	adj:pl:nom:m1:pos
ludzie	człowiek	subst:pl:nom:m1
i	i	conj
przedsiębiorcy	przedsiębiorca	subst:pl:nom:m1
radzą	radzić	fin:pl:ter:imperf
sobie	siebie	siebie:dat
z	z	prep:inst:nwok
tą	ten	adj:sg:inst:f:pos
instytucją	instytucja	subst:sg:inst:f
.	.	interp
Wspomniała	wspomnieć	praet:sg:f:perf
m	być	aglt:sg:pri:imperf:nwok
o	o	prep:loc
jednym	jeden	adj:sg:loc:m3:pos
ze	z	prep:gen:wok
sposobów	sposób	subst:pl:gen:m3
,	,	interp
o	o	prep:loc
którym	który	adj:sg:loc:m3:pos
pisze	pisać	fin:sg:ter:imperf
dzisiejsza	dzisiejszy	adj:sg:nom:f:pos
Wyborcza	wyborczy	adj:sg:nom:f:pos
ERROR http://wyborcza.pl/1,75478,7072995,Na_ZUS_nie_plac	http	//wyborcza.pl/1,75478,7072995,Na_ZUS_nie_plac:subst:sg:nom:m3
.	.	interp
.	.	interp
.	.	interp
Bez	bez	prep:gen:nwok
podawania	podawać	ger:sg:gen:n:imperf:aff
nazw	nazwa	subst:pl:gen:f
firm	firma	subst:pl:gen:f
,	,	interp
ale	ale	conj
w	w	prep:acc:nwok
taki	taki	adj:sg:acc:m3:pos
sposób	sposób	subst:sg:acc:m3
,	,	interp
że	że	comp
każdy	każdy	adj:sg:nom:m1:pos
kto	kto	subst:sg:nom:m1
chciał	chcieć	praet:sg:m1:imperf
mógł	móc	praet:sg:m1:imperf:nagl
zobaczyć	zobaczyć	inf:perf
,	,	interp
o	o	prep:acc
jakie	jaki	adj:pl:acc:f:pos
firmy	firma	subst:pl:acc:f
chodzi	chodzić	fin:sg:ter:imperf
.	.	interp
Sprawę	sprawa	subst:sg:acc:f
opisał	opisać	praet:sg:m3:perf
też	też	qub
"	"	interp
już	już	qub
w	w	prep:loc:nwok
sierpniu	sierpień	subst:sg:loc:m3
"	"	interp
portal	portal	subst:sg:nom:m3
Onet.eu	Onet.eu	subst:sg:nom:m3
,	,	interp
dokładnie	dokładnie	qub
31	31	adj:sg:gen:m3:pos
sierpnia	sierpień	subst:sg:gen:m3
.	.	interp
Sprawdźcie	sprawdzić	impt:pl:sec:perf
proszę	prosić	fin:sg:pri:imperf
datę	data	subst:sg:acc:f
mojego	mój	adj:sg:gen:m3:pos
tekstu	tekst	subst:sg:gen:m3
.	.	interp
