Daniel	Daniel	subst:sg:nom:m1
Stefański	Stefański	subst:sg:nom:m1
z	z	prep:gen:nwok
EGB	EGB	subst:sg:gen:n
Investments	Investments	subst:sg:gen:n
przyznaje	przyznawać	fin:sg:ter:imperf
,	,	interp
że	że	comp
umieszczenie	umieścić	ger:sg:nom:n:perf:aff
zalegającej	zalegać	pact:sg:gen:f:imperf:aff
z	z	prep:inst:nwok
płatnościami	płatność	subst:pl:inst:f
firmy	firma	subst:sg:gen:f
na	na	prep:loc
liście	lista	subst:sg:loc:f
dłużników	dłużnik	subst:pl:gen:m1
jest	być	fin:sg:ter:imperf
traktowane	traktować	ppas:sg:nom:n:imperf:aff
przez	przez	prep:acc:nwok
wielu	wiele	num:pl:acc:m1:rec
klientów	klient	subst:pl:gen:m1
jako	jako	prep:nom
dodatkowe	dodatkowy	adj:sg:nom:n:pos
narzędzie	narzędzie	subst:sg:nom:n
windykacyjne	windykacyjny	adj:sg:nom:n:pos
i	i	conj
sposób	sposób	subst:sg:nom:m3
na	na	prep:acc
zdyscyplinowanie	zdyscyplinować	ger:sg:acc:n:perf:aff
dłużnika	dłużnik	subst:sg:gen:m1
.	.	interp
-	-	interp
Ta	ten	adj:sg:nom:f:pos
opcja	opcja	subst:sg:nom:f
dostępna	dostępny	adj:sg:nom:f:pos
jest	być	fin:sg:ter:imperf
tylko	tylko	qub
dla	dla	prep:gen
firm	firma	subst:pl:gen:f
i	i	conj
można	można	pred
ją	on	ppron3:sg:acc:f:ter:akc:npraep
stosować	stosować	inf:imperf
wyłącznie	wyłącznie	qub
wobec	wobec	prep:gen
firm	firma	subst:pl:gen:f
.	.	interp
Każdy	każdy	adj:sg:nom:m1:pos
kto	kto	subst:sg:nom:m1
chce	chcieć	fin:sg:ter:imperf
z	z	prep:gen:nwok
niej	on	ppron3:sg:gen:f:ter:akc:praep
skorzystać	skorzystać	inf:perf
,	,	interp
musi	musieć	fin:sg:ter:imperf
przesłać	przesłać	inf:perf
do	do	prep:gen
nas	my	ppron12:pl:gen:m1:pri
oryginał	oryginał	subst:sg:acc:m3
dokumentu	dokument	subst:sg:gen:m3
rejestrowego	rejestrowy	adj:sg:gen:m3:pos
.	.	interp
Firma	firma	subst:sg:nom:f
umieszczająca	umieszczać	pact:sg:nom:f:imperf:aff
swoje	swój	adj:pl:acc:f:pos
wierzytelności	wierzytelność	subst:pl:acc:f
ponosi	ponosić	fin:sg:ter:imperf
odpowiedzialność	odpowiedzialność	subst:sg:acc:f
za	za	prep:acc
prawdziwość	prawdziwość	subst:sg:acc:f
wprowadzanych	wprowadzać	ppas:pl:gen:f:imperf:aff
informacji	informacja	subst:pl:gen:f
.	.	interp
W	w	prep:loc:nwok
zeszłym	zeszły	adj:sg:loc:m3:pos
roku	rok	subst:sg:loc:m3
w	w	prep:loc:nwok
naszym	nasz	adj:sg:loc:m3:pos
Internecie	Internet	subst:sg:loc:m3
pojawiły	pojawić	praet:pl:m3:perf
się	się	qub
dwa	dwa	num:pl:nom:m3:congr
serwisy	serwis	subst:pl:nom:m3
,	,	interp
które	który	adj:pl:nom:m3:pos
przyjęły	przyjąć	praet:pl:m3:perf
trochę	trochę	adv
inną	inny	adj:sg:acc:f:pos
filozofię	filozofia	subst:sg:acc:f
działania	działanie	subst:sg:gen:n
.	.	interp
Nie	nie	qub
publikują	publikować	fin:pl:ter:imperf
danych	dana	subst:pl:gen:f
osobowych	osobowy	adj:pl:gen:f:pos
,	,	interp
ale	ale	conj
oferują	oferować	fin:pl:ter:imperf
aukcję	aukcja	subst:sg:acc:f
i	i	conj
windykację	windykacja	subst:sg:acc:f
długów	dług	subst:pl:gen:m3
oraz	oraz	conj
pomoc	pomoc	subst:sg:acc:f
w	w	prep:loc:nwok
samodzielnym	samodzielny	adj:sg:loc:n:pos
dochodzeniu	dochodzić	ger:sg:loc:n:imperf:aff
swoich	swój	adj:pl:gen:f:pos
spraw	sprawa	subst:pl:gen:f
.	.	interp
Jako	jako	conj
pierwsza	pierwszy	adj:sg:nom:f:pos
w	w	prep:loc:nwok
lipcu	lipiec	subst:sg:loc:m3
zeszłego	zeszły	adj:sg:gen:m3:pos
roku	rok	subst:sg:gen:m3
wystartowała	wystartować	praet:sg:f:perf
witryna	witryna	subst:sg:nom:f
windykacja.pl	windykacja.pl	subst:sg:nom:m3
,	,	interp
którą	który	adj:sg:acc:f:pos
prowadzi	prowadzić	fin:sg:ter:imperf
wrocławska	wrocławski	adj:sg:nom:f:pos
spółka	spółka	subst:sg:nom:f
Narodowa	narodowy	adj:sg:nom:f:pos
Centrala	centrala	subst:sg:nom:f
Windykacji	windykacja	subst:sg:gen:f
.	.	interp
Na	na	prep:loc
jej	on	ppron3:sg:gen:f:ter:akc:npraep
stronach	strona	subst:pl:loc:f
można	można	pred
zgłaszać	zgłaszać	inf:imperf
propozycje	propozycja	subst:pl:acc:f
kupna	kupno	subst:sg:gen:n
i	i	conj
sprzedaży	sprzedaż	subst:sg:gen:f
wierzytelności	wierzytelność	subst:pl:gen:f
.	.	interp
Działa	działać	fin:sg:ter:imperf
też	też	qub
wyszukiwarka	wyszukiwarka	subst:sg:nom:f
ofert	oferta	subst:pl:gen:f
.	.	interp
Przez	przez	prep:acc:nwok
serwis	serwis	subst:sg:acc:m3
klienci	klient	subst:pl:nom:m1
firmy	firma	subst:sg:gen:f
zlecają	zlecać	fin:pl:ter:imperf
jej	on	ppron3:sg:dat:f:ter:akc:npraep
też	też	qub
windykację	windykacja	subst:sg:acc:f
długów	dług	subst:pl:gen:m3
.	.	interp
Później	późno	adv:com
poprzez	poprzez	prep:acc:nwok
Internet	Internet	subst:sg:acc:m3
mogą	móc	fin:pl:ter:imperf
na	na	prep:acc
bieżąco	bieżąco	adv:pos
sprawdzać	sprawdzać	inf:imperf
,	,	interp
jak	jak	adv:pos
postępują	postępować	fin:pl:ter:imperf
ich	on	ppron3:pl:gen:m1:ter:akc:npraep
sprawy	sprawa	subst:pl:nom:f
.	.	interp
Informacje	informacja	subst:pl:nom:f
na	na	prep:acc
ten	ten	adj:sg:acc:m3:pos
temat	temat	subst:sg:acc:m3
są	być	fin:pl:ter:imperf
uaktualniane	uaktualniać	ppas:pl:nom:f:imperf:aff
codziennie	codziennie	adv:pos
.	.	interp
Osoby	osoba	subst:pl:nom:f
,	,	interp
które	który	adj:pl:nom:f:pos
samodzielnie	samodzielnie	adv:pos
chcą	chcieć	fin:pl:ter:imperf
zająć	zająć	inf:perf
się	się	qub
odzyskaniem	odzyskać	ger:sg:inst:n:perf:aff
swoich	swój	adj:pl:gen:m3:pos
pieniędzy	pieniądz	subst:pl:gen:m3
,	,	interp
kupić	kupić	inf:perf
albo	albo	conj
sprzedać	sprzedać	inf:perf
długi	dług	subst:pl:acc:m3
,	,	interp
na	na	prep:loc
windykacji.pl	windykacja.pl	subst:sg:loc:m3
znajdą	znaleźć	fin:pl:ter:perf
też	też	qub
komplet	komplet	subst:sg:acc:m3
informacji	informacja	subst:pl:gen:f
i	i	conj
gotowych	gotowy	adj:pl:gen:m3:pos
do	do	prep:gen
wypełnienia	wypełnić	ger:sg:gen:n:perf:aff
wzorów	wzór	subst:pl:gen:m3
dokumentów	dokument	subst:pl:gen:m3
.	.	interp
Bank	bank	subst:sg:nom:m3
Gospodarki	gospodarka	subst:sg:gen:f
Żywnościowej	żywnościowy	adj:sg:gen:f:pos
SA	SA	subst:sg:nom:f
zwiększył	zwiększyć	praet:sg:m3:perf
oprocentowanie	oprocentowanie	subst:sg:acc:n
konta	konto	subst:sg:gen:n
osobistego	osobisty	adj:sg:gen:n:pos
Integrum	Integrum	subst:sg:nom:n
i	i	conj
konta	konto	subst:sg:gen:n
dla	dla	prep:gen
młodzieży	młodzież	subst:sg:gen:f
Integrum	Integrum	subst:sg:nom:n
Maax	Maax	subst:sg:nom:n
o	o	prep:acc
jeden	jeden	adj:sg:acc:m3:pos
punkt	punkt	subst:sg:acc:m3
procentowy	procentowy	adj:sg:acc:m3:pos
z	z	prep:gen:nwok
1,75	1,75	num:pl:gen:m3:rec
do	do	prep:gen
2,75	2,75	num:pl:gen:m3:rec
proc	procent	brev:pun
.	.	interp
Jednocześnie	jednocześnie	adv:pos
bank	bank	subst:sg:nom:m3
już	już	qub
po	po	prep:acc
raz	raz	subst:sg:acc:m3
piąty	piąty	adj:sg:acc:m3:pos
z	z	prep:gen:nwok
rzędu	rząd	subst:sg:gen:m3
otrzymał	otrzymać	praet:sg:m3:perf
od	od	prep:gen:nwok
American	American	subst:sg:gen:m3
Express	Express	subst:sg:gen:m3
certyfikat	certyfikat	subst:sg:acc:m3
jakości	jakość	subst:sg:gen:f
.	.	interp
Wyróżnienie	wyróżnienie	subst:sg:acc:n
przyznano	przyznać	imps:perf
za	za	prep:acc
bezbłędną	bezbłędny	adj:sg:acc:f:pos
realizację	realizacja	subst:sg:acc:f
przekazów	przekaz	subst:pl:gen:m3
zagranicznych	zagraniczny	adj:pl:gen:m3:pos
.	.	interp
BGŻ	BGŻ	subst:sg:nom:m3
SA	SA	subst:sg:nom:f
i	i	conj
American	American	subst:sg:nom:m3
Express	Express	subst:sg:nom:m3
Bank	bank	subst:sg:nom:m3
wspólnie	wspólnie	adv:pos
rozliczają	rozliczać	fin:pl:ter:imperf
transakcje	transakcja	subst:pl:acc:f
handlu	handel	subst:sg:gen:m3
zagranicznego	zagraniczny	adj:sg:gen:m3:pos
w	w	prep:loc:nwok
USA	USA	subst:pl:loc:n
i	i	conj
w	w	prep:loc:nwok
strefie	strefa	subst:sg:loc:f
euro	euro	subst:sg:gen:n
.	.	interp
Certyfikat	certyfikat	subst:sg:nom:m3
jest	być	fin:sg:ter:imperf
przyznawany	przyznawać	ppas:sg:nom:m3:imperf:aff
instytucjom	instytucja	subst:pl:dat:f
finansowym	finansowy	adj:pl:dat:f:pos
w	w	prep:loc:nwok
okresach	okres	subst:pl:loc:m3
półrocznych	półroczny	adj:pl:loc:m3:pos
.	.	interp
Członek	członek	subst:sg:nom:m1
Zarządu	zarząd	subst:sg:gen:m3
Miasta	miasto	subst:sg:gen:n
przyznał	przyznać	praet:sg:m1:perf
,	,	interp
że	że	comp
dotychczasowy	dotychczasowy	adj:sg:nom:m3:pos
system	system	subst:sg:nom:m3
umożliwiał	umożliwiać	praet:sg:m3:imperf
branie	brać	ger:sg:acc:n:imperf:aff
łapówek	łapówka	subst:pl:gen:f
przez	przez	prep:acc:nwok
inspektorów	inspektor	subst:pl:acc:m1
.	.	interp
To	to	subst:sg:acc:n
-	-	interp
czy	czy	qub
rzeczywiście	rzeczywiście	adv:pos
dochodziło	dochodzić	praet:sg:n:imperf
do	do	prep:gen
takich	taki	adj:pl:gen:m3:pos
przypadków	przypadek	subst:pl:gen:m3
-	-	interp
mają	mieć	fin:pl:ter:imperf
wyjaśnić	wyjaśnić	inf:perf
organy	organ	subst:pl:nom:m3
ścigania	ściganie	subst:sg:gen:n
.	.	interp
Zastanawiające	zastanawiający	adj:sg:nom:n:pos
jednak	jednak	conj
,	,	interp
że	że	comp
ów	ów	adj:sg:nom:m1:pos
członek	członek	subst:sg:nom:m1
Zarządu	zarząd	subst:sg:gen:m3
Miasta	miasto	subst:sg:gen:n
dostrzega	dostrzegać	fin:sg:ter:imperf
fakt	fakt	subst:sg:acc:m3
konieczności	konieczność	subst:sg:gen:f
zamontowania	zamontować	ger:sg:gen:n:perf:aff
parkomatów	parkomat	subst:pl:gen:m3
w	w	prep:loc:nwok
mieście	miasto	subst:sg:loc:n
dopiero	dopiero	qub
po	po	prep:loc
.	.	interp
.	.	interp
.	.	interp
blisko	blisko	qub
ośmiu	osiem	num:pl:loc:m3:congr
latach	rok	subst:pl:loc:m3
funkcjonowania	funkcjonowanie	subst:sg:gen:n
Strefy	strefa	subst:sg:gen:f
PP	PP	subst:sg:nom:n
.	.	interp
-	-	interp
Co	co	subst:sg:acc:n
więc	więc	conj
pańskim	pański	adj:sg:inst:n:pos
zdaniem	zdanie	subst:sg:inst:n
należy	należeć	fin:sg:ter:imperf
robić	robić	inf:imperf
?	?	interp
-	-	interp
Wielce	wielce	adv:pos
prawdopodobna	prawdopodobny	adj:sg:nom:f:pos
konieczność	konieczność	subst:sg:nom:f
sprzedaży	sprzedaż	subst:sg:gen:f
przez	przez	prep:acc:nwok
PŻB	PŻB	subst:sg:acc:f
części	część	subst:sg:gen:f
floty	flota	subst:sg:gen:f
z	z	prep:gen:nwok
jednej	jeden	adj:sg:gen:f:pos
strony	strona	subst:sg:gen:f
oraz	oraz	conj
konieczność	konieczność	subst:sg:nom:f
przyjrzenia	przyjrzeć	ger:sg:gen:n:perf:aff
się	się	qub
potrzebom	potrzeba	subst:pl:dat:f
wymiany	wymiana	subst:sg:gen:f
jednego	jeden	adj:sg:gen:m3:pos
z	z	prep:gen:nwok
naszych	nasz	adj:pl:gen:m3:pos
promów	prom	subst:pl:gen:m3
z	z	prep:gen:nwok
drugiej	drugi	adj:sg:gen:f:pos
,	,	interp
rysuje	rysować	fin:sg:ter:imperf
możliwość	możliwość	subst:sg:acc:f
wymiany	wymiana	subst:sg:gen:f
dwóch	dwa	num:pl:gen:m3:congr
starszych	stary	adj:pl:gen:m3:com
statków	statek	subst:pl:gen:m3
na	na	prep:acc
jeden	jeden	adj:sg:acc:m3:pos
nowszy	nowy	adj:sg:acc:m3:com
,	,	interp
odpowiadający	odpowiadać	pact:sg:acc:m3:imperf:aff
wymogom	wymóg	subst:pl:dat:m3
rynku	rynek	subst:sg:gen:m3
.	.	interp
Daniel	Daniel	subst:sg:nom:m1
Stefański	Stefański	subst:sg:nom:m1
sądzi	sądzić	fin:sg:ter:imperf
,	,	interp
że	że	comp
ewolucja	ewolucja	subst:sg:nom:f
tego	ten	adj:sg:gen:m3:pos
typu	typ	subst:sg:gen:m3
witryn	witryna	subst:pl:gen:f
zmierza	zmierzać	fin:sg:ter:imperf
w	w	prep:loc:nwok
kierunku	kierunek	subst:sg:loc:m3
serwisów	serwis	subst:pl:gen:m3
akcyjnych	akcyjny	adj:pl:gen:m3:pos
z	z	prep:gen:nwok
prawdziwego	prawdziwy	adj:sg:gen:n:pos
zdarzenia	zdarzenie	subst:sg:gen:n
.	.	interp
-	-	interp
Jedyną	jedyny	adj:sg:inst:f:pos
barierą	bariera	subst:sg:inst:f
opóźniającą	opóźniać	pact:sg:inst:f:imperf:aff
ich	on	ppron3:pl:gen:m3:ter:akc:npraep
tworzenie	tworzyć	ger:sg:acc:n:imperf:aff
jest	być	fin:sg:ter:imperf
świadomość	świadomość	subst:sg:nom:f
ludzi	człowiek	subst:pl:gen:m1
.	.	interp
Po	po	prep:acc
prostu	prosty	adjp
rynek	rynek	subst:sg:nom:m3
nie	nie	qub
jest	być	fin:sg:ter:imperf
jeszcze	jeszcze	qub
na	na	prep:acc
to	to	subst:sg:acc:n
przygotowany	przygotować	ppas:sg:nom:m3:perf:aff
.	.	interp
W	w	prep:loc:nwok
tej	ten	adj:sg:loc:f:pos
chwili	chwila	subst:sg:loc:f
pogarszająca	pogarszać	pact:sg:nom:f:imperf:aff
się	się	qub
sytuacja	sytuacja	subst:sg:nom:f
gospodarcza	gospodarczy	adj:sg:nom:f:pos
sprawia	sprawiać	fin:sg:ter:imperf
,	,	interp
że	że	comp
do	do	prep:gen
firm	firma	subst:pl:gen:f
windykacyjnych	windykacyjny	adj:pl:gen:f:pos
trafia	trafiać	fin:sg:ter:imperf
coraz	coraz	adv
więcej	więcej	num:pl:nom:f:rec
trudnych	trudny	adj:pl:gen:f:pos
wierzytelności	wierzytelność	subst:pl:gen:f
.	.	interp
Klienci	klient	subst:pl:nom:m1
zgłaszają	zgłaszać	fin:pl:ter:imperf
się	się	qub
z	z	prep:inst:nwok
tysiącami	tysiąc	subst:pl:inst:m3
faktur	faktura	subst:pl:gen:f
miesięcznie	miesięcznie	adv:pos
.	.	interp
Ich	on	ppron3:pl:gen:f:ter:akc:npraep
obsługa	obsługa	subst:sg:nom:f
wymaga	wymagać	fin:sg:ter:imperf
dużej	duży	adj:sg:gen:f:pos
sprawności	sprawność	subst:sg:gen:f
.	.	interp
Z	z	prep:gen:nwok
kolei	kolej	subst:sg:gen:f
Marek	Marek	subst:sg:nom:m1
Kłuciński	Kłuciński	subst:sg:nom:m1
,	,	interp
dyrektor	dyrektor	subst:sg:nom:m1
public	public	subst:sg:gen:n
relation	relation	subst:sg:gen:n
BPH	BPH	subst:sg:gen:m3
PBK	PBK	subst:sg:gen:m3
,	,	interp
przyznał	przyznać	praet:sg:m1:perf
,	,	interp
że	że	comp
porozumienie	porozumienie	subst:sg:nom:n
banków	bank	subst:pl:gen:m3
kieruje	kierować	fin:sg:ter:imperf
piłeczkę	piłeczka	subst:sg:acc:f
w	w	prep:loc:nwok
kierunku	kierunek	subst:sg:loc:m3
resortu	resort	subst:sg:gen:m3
.	.	interp
Odmówił	odmówić	praet:sg:m1:perf
podania	podać	ger:sg:gen:n:perf:aff
warunków	warunek	subst:pl:gen:m3
restrukturyzacji	restrukturyzacja	subst:sg:gen:f
holdingu	holding	subst:sg:gen:m3
,	,	interp
gdyż	gdyż	comp
"	"	interp
firma	firma	subst:sg:nom:f
najpierw	najpierw	adv
musi	musieć	fin:sg:ter:imperf
być	być	inf:imperf
przebadana	przebadać	ppas:sg:nom:f:perf:aff
"	"	interp
.	.	interp
Nieoficjalnie	nieoficjalnie	adv:pos
dowiedzieli	dowiedzieć	praet:pl:m1:perf
śmy	być	aglt:pl:pri:imperf:nwok
się	się	qub
,	,	interp
że	że	comp
banki	bank	subst:pl:nom:m3
wierzycielskie	wierzycielski	adj:pl:nom:m3:pos
zażądały	zażądać	praet:pl:m3:perf
150-procentowego	150-procentowy	adj:sg:gen:n:pos
zabezpieczenia	zabezpieczenie	subst:sg:gen:n
(	(	interp
ok	około	brev:pun
.	.	interp
60	60	num:pl:gen:m3:congr
mln	milion	brev:npun
USD	USD	subst:pl:gen:m2
)	)	interp
na	na	prep:acc
kredyt	kredyt	subst:sg:acc:m3
pomostowy	pomostowy	adj:sg:acc:m3:pos
w	w	prep:loc:nwok
wysokości	wysokość	subst:sg:loc:f
40	40	num:pl:gen:m3:congr
mln	milion	brev:npun
USD	USD	subst:pl:gen:m2
.	.	interp
Oznacza	oznaczać	fin:sg:ter:imperf
to	to	subst:sg:nom:n
,	,	interp
że	że	comp
rząd	rząd	subst:sg:nom:m3
powinien	powinien	winien:sg:m3:imperf
dokapitalizować	dokapitalizować	inf:perf
ARP	ARP	subst:sg:acc:f
akcjami	akcja	subst:pl:inst:f
Skarbu	skarb	subst:sg:gen:m3
Państwa	państwo	subst:sg:gen:n
,	,	interp
które	który	adj:pl:acc:f:pos
posiada	posiadać	fin:sg:ter:imperf
w	w	prep:loc:nwok
giełdowych	giełdowy	adj:pl:loc:f:pos
spółkach	spółka	subst:pl:loc:f
.	.	interp
Od	od	prep:gen:nwok
przyszłego	przyszły	adj:sg:gen:m3:pos
roku	rok	subst:sg:gen:m3
kierowcy	kierowca	subst:pl:nom:m1
ciężarówek	ciężarówka	subst:pl:gen:f
będą	być	bedzie:pl:ter:imperf
musieli	musieć	praet:pl:m1:imperf
płacić	płacić	inf:imperf
za	za	prep:acc
korzystanie	korzystać	ger:sg:acc:n:imperf:aff
z	z	prep:gen:nwok
niemieckich	niemiecki	adj:pl:gen:f:pos
autostrad	autostrada	subst:pl:gen:f
.	.	interp
Rząd	rząd	subst:sg:nom:m3
spodziewa	spodziewać	fin:sg:ter:imperf
się	się	qub
wpływów	wpływ	subst:pl:gen:m3
w	w	prep:loc:nwok
wysokości	wysokość	subst:sg:loc:f
3,4	3,4	num:pl:gen:m3:congr
mld	miliard	brev:npun
euro	euro	subst:pl:gen:n
rocznie	rocznie	adv:pos
.	.	interp
Zgodnie	zgodnie	adv:pos
z	z	prep:inst:nwok
ustawą	ustawa	subst:sg:inst:f
właściciele	właściciel	subst:pl:nom:m1
ciężarówek	ciężarówka	subst:pl:gen:f
o	o	prep:loc
wadze	waga	subst:sg:loc:f
całkowitej	całkowity	adj:sg:loc:f:pos
ponad	ponad	qub
12	12	num:pl:acc:f:rec
ton	tona	subst:pl:gen:f
zapłacą	zapłacić	fin:pl:ter:perf
średnio	średnio	adv:pos
15	15	num:pl:acc:m2:rec
centów	cent	subst:pl:gen:m2
za	za	prep:acc
każdy	każdy	adj:sg:acc:m3:pos
przejechany	przejechać	ppas:sg:acc:m3:perf:aff
kilometr	kilometr	subst:sg:acc:m3
.	.	interp
Wysokość	wysokość	subst:sg:nom:f
opłaty	opłata	subst:sg:gen:f
zależy	zależeć	fin:sg:ter:imperf
od	od	prep:gen:nwok
liczby	liczba	subst:sg:gen:f
osi	oś	subst:pl:gen:f
samochodu	samochód	subst:sg:gen:m3
i	i	conj
emisji	emisja	subst:sg:gen:f
spalin	spaliny	subst:pl:gen:n
.	.	interp
Z	z	prep:gen:nwok
niemieckich	niemiecki	adj:pl:gen:f:pos
dróg	droga	subst:pl:gen:f
korzysta	korzystać	fin:sg:ter:imperf
rocznie	rocznie	adv:pos
od	od	prep:gen:nwok
4,5	4,5	num:pl:gen:m3:congr
do	do	prep:gen
5	5	num:pl:gen:m3:congr
milionów	milion	subst:pl:gen:m3
ciężarówek	ciężarówka	subst:pl:gen:f
.	.	interp
"	"	interp
Pani	pani	subst:sg:nom:f
Parker	Parker	subst:sg:nom:f
Bowles	Bowles	subst:sg:nom:f
od	od	prep:gen:nwok
wielu	wiele	num:pl:gen:m3:congr
lat	rok	subst:pl:gen:m3
znała	znać	praet:sg:f:imperf
królową	królowa	subst:sg:acc:f
-	-	interp
matkę	matka	subst:sg:acc:f
i	i	conj
jej	on	ppron3:sg:gen:f:ter:akc:npraep
obecność	obecność	subst:sg:nom:f
(	(	interp
na	na	prep:loc
pogrzebie	pogrzeb	subst:sg:loc:m3
)	)	interp
będzie	być	bedzie:sg:ter:imperf
słuszna	słuszny	adj:sg:nom:f:pos
i	i	conj
właściwa	właściwy	adj:sg:nom:f:pos
"	"	interp
-	-	interp
powiedział	powiedzieć	praet:sg:m1:perf
agencji	agencja	subst:sg:dat:f
Reuters	Reuters	subst:sg:nom:m2
rzecznik	rzecznik	subst:sg:nom:m1
Pałacu	pałac	subst:sg:gen:m3
.	.	interp
Królowa	królowa	subst:sg:nom:f
-	-	interp
matka	matka	subst:sg:nom:f
,	,	interp
która	który	adj:sg:nom:f:pos
miała	mieć	praet:sg:f:imperf
duży	duży	adj:sg:acc:m3:pos
wpływ	wpływ	subst:sg:acc:m3
na	na	prep:acc
Karola	Karol	subst:sg:acc:m1
,	,	interp
miała	mieć	praet:sg:f:imperf
konserwatywne	konserwatywny	adj:pl:acc:m3:pos
poglądy	pogląd	subst:pl:acc:m3
na	na	prep:acc
małżeństwo	małżeństwo	subst:sg:acc:n
i	i	conj
rozwód	rozwód	subst:sg:acc:m3
.	.	interp
Media	medium	subst:pl:nom:n
utrzymywały	utrzymywać	praet:pl:n:imperf
,	,	interp
że	że	comp
niechętnie	niechętnie	adv:pos
odnosiła	odnosić	praet:sg:f:imperf
się	się	qub
do	do	prep:gen
związku	związek	subst:sg:gen:m3
wnuka	wnuk	subst:sg:gen:m1
z	z	prep:inst:nwok
rozwódką	rozwódka	subst:sg:inst:f
Parker	Parker	subst:sg:inst:f
Bowles	Bowles	subst:sg:inst:f
.	.	interp
Hans	Hans	subst:sg:nom:m1
-	-	interp
Dietrich	Dietrich	subst:sg:nom:m1
Genscher	Genscher	subst:sg:nom:m1
należy	należeć	fin:sg:ter:imperf
do	do	prep:gen
najwybitniejszych	wybitny	adj:pl:gen:m1:sup
kreatorów	kreator	subst:pl:gen:m1
powojennej	powojenny	adj:sg:gen:f:pos
polityki	polityka	subst:sg:gen:f
europejskiej	europejski	adj:sg:gen:f:pos
.	.	interp
Fascynująca	fascynujący	adj:sg:nom:f:pos
jest	być	fin:sg:ter:imperf
lektura	lektura	subst:sg:nom:f
jego	on	ppron3:sg:gen:m1:ter:akc:npraep
wystąpień	wystąpienie	subst:pl:gen:n
,	,	interp
zawsze	zawsze	adv
bardzo	bardzo	adv:pos
konkretnych	konkretny	adj:pl:gen:n:pos
,	,	interp
opartych	oprzeć	ppas:pl:gen:n:perf:aff
o	o	prep:acc
głęboką	głęboki	adj:sg:acc:f:pos
analizę	analiza	subst:sg:acc:f
europejskiej	europejski	adj:sg:gen:f:pos
myśli	myśl	subst:sg:gen:f
historycznej	historyczny	adj:sg:gen:f:pos
.	.	interp
Zadziwia	zadziwiać	fin:sg:ter:imperf
upór	upór	subst:sg:nom:m3
i	i	conj
konsekwencja	konsekwencja	subst:sg:nom:f
,	,	interp
której	który	adj:sg:gen:f:pos
niejednokrotnie	niejednokrotnie	adv:pos
dowiódł	dowieść	praet:sg:m1:perf:nagl
,	,	interp
choćby	choćby	qub
w	w	prep:loc:nwok
ONZ	ONZ	subst:sg:loc:f
,	,	interp
gdy	gdy	adv
występując	występować	pcon:imperf
jako	jako	conj
minister	minister	subst:sg:nom:m1
spraw	sprawa	subst:pl:gen:f
zagranicznych	zagraniczny	adj:pl:gen:f:pos
RFN	RFN	subst:sg:gen:f
swoje	swój	adj:pl:acc:n:pos
przemówienia	przemówienie	subst:pl:acc:n
kończył	kończyć	praet:sg:m1:imperf
przypomnieniem	przypomnieć	ger:sg:inst:n:perf:aff
,	,	interp
że	że	comp
podział	podział	subst:sg:nom:m3
Niemiec	Niemcy	subst:pl:gen:n
,	,	interp
Berlina	Berlin	subst:sg:gen:m3
i	i	conj
Europy	Europa	subst:sg:gen:f
nie	nie	qub
jest	być	fin:sg:ter:imperf
ostatnim	ostatni	adj:sg:inst:n:pos
słowem	słowo	subst:sg:inst:n
historii	historia	subst:sg:gen:f
.	.	interp
Aż	aż	comp
w	w	prep:loc:nwok
końcu	koniec	subst:sg:loc:m3
podział	podział	subst:sg:nom:m3
ten	ten	adj:sg:nom:m3:pos
został	zostać	praet:sg:m3:perf
przezwyciężony	przezwyciężyć	ppas:sg:nom:m3:perf:aff
.	.	interp
Jak	jak	adv:pos
poinformował	poinformować	praet:sg:m1:perf
nas	my	ppron12:pl:acc:m1:pri
prof	profesor	brev:pun
.	.	interp
Leszek	Leszek	subst:sg:nom:m1
Pacholski	Pacholski	subst:sg:nom:m1
,	,	interp
przewodniczący	przewodniczący	subst:sg:nom:m1
rady	rada	subst:sg:gen:f
nadzorczej	nadzorczy	adj:sg:gen:f:pos
Porty	Porta	subst:sg:gen:f
Holding	holding	subst:sg:nom:m3
,	,	interp
wśród	wśród	prep:gen
najważniejszych	ważny	adj:pl:gen:n:sup
zadań	zadanie	subst:pl:gen:n
rady	rada	subst:sg:gen:f
są	być	fin:pl:ter:imperf
m.in	między innymi	brev:pun
.	.	interp
ERROR :		:interp
-	-	interp
stały	stały	adj:sg:nom:m3:pos
monitoring	monitoring	subst:sg:nom:m3
ogólnej	ogólny	adj:sg:gen:f:pos
strategii	strategia	subst:sg:gen:f
spółki	spółka	subst:sg:gen:f
oraz	oraz	conj
kontrolę	kontrola	subst:sg:acc:f
osiągania	osiągać	ger:sg:gen:n:imperf:aff
okresowych	okresowy	adj:pl:gen:m3:pos
celów	cel	subst:pl:gen:m3
przedsiębiorstwa	przedsiębiorstwo	subst:sg:gen:n
,	,	interp
-	-	interp
ocenę	ocena	subst:sg:acc:f
sprawozdań	sprawozdanie	subst:pl:gen:n
zarządu	zarząd	subst:sg:gen:m3
i	i	conj
sprawozdań	sprawozdanie	subst:pl:gen:n
finansowych	finansowy	adj:pl:gen:n:pos
za	za	prep:acc
miniony	miniony	adj:sg:acc:m3:pos
rok	rok	subst:sg:acc:m3
obrotowy	obrotowy	adj:sg:acc:m3:pos
spółki	spółka	subst:sg:gen:f
oraz	oraz	conj
wniosków	wniosek	subst:pl:gen:m3
zarządu	zarząd	subst:sg:gen:m3
w	w	prep:loc:nwok
sprawie	sprawa	subst:sg:loc:f
podziału	podział	subst:sg:gen:m3
zysku	zysk	subst:sg:gen:m3
albo	albo	conj
pokrycia	pokryć	ger:sg:gen:n:perf:aff
straty	strata	subst:sg:gen:f
,	,	interp
-	-	interp
dobór	dobór	subst:sg:nom:m3
i	i	conj
odwoływanie	odwoływać	ger:sg:nom:n:imperf:aff
członków	członek	subst:pl:gen:m1
zarządu	zarząd	subst:sg:gen:m3
oraz	oraz	conj
ustalenie	ustalić	ger:sg:nom:n:perf:aff
ich	on	ppron3:pl:gen:m1:ter:akc:npraep
wynagrodzeń	wynagrodzenie	subst:pl:gen:n
,	,	interp
-	-	interp
nadzorowanie	nadzorować	ger:sg:nom:n:imperf:aff
ważniejszych	ważny	adj:pl:gen:m3:com
wydatków	wydatek	subst:pl:gen:m3
inwestycyjnych	inwestycyjny	adj:pl:gen:m3:pos
oraz	oraz	conj
zaciągania	zaciągać	ger:sg:gen:n:imperf:aff
kredytów	kredyt	subst:pl:gen:m3
.	.	interp
W	w	prep:acc:nwok
NAJBLIŻSZY	bliski	adj:sg:acc:m3:sup
czwartek	czwartek	subst:sg:acc:m3
Hansowi	Hans	subst:sg:dat:m1
-	-	interp
Dietrichowi	Dietrich	subst:sg:dat:m1
Genscherowi	Genscher	subst:sg:dat:m1
,	,	interp
wieloletniemu	wieloletni	adj:sg:dat:m1:pos
ministrowi	minister	subst:sg:dat:m1
spraw	sprawa	subst:pl:gen:f
zagranicznych	zagraniczny	adj:pl:gen:f:pos
RFN	RFN	subst:sg:gen:f
,	,	interp
nadany	nadać	ppas:sg:nom:m3:perf:aff
zostanie	zostać	fin:sg:ter:perf
dwunasty	dwunasty	adj:sg:nom:m3:pos
tytuł	tytuł	subst:sg:nom:m3
doktora	doktor	subst:sg:gen:m1
honoris	honoris	subst:sg:gen:m3
causa	causa	subst:sg:gen:m3
Uniwersytetu	uniwersytet	subst:sg:gen:m3
Szczecińskiego	szczeciński	adj:sg:gen:m3:pos
.	.	interp
Wniosek	wniosek	subst:sg:acc:m3
przedstawiła	przedstawić	praet:sg:f:perf
Rada	rada	subst:sg:nom:f
Wydziału	wydział	subst:sg:gen:m3
Nauk	nauka	subst:pl:gen:f
Ekonomicznych	ekonomiczny	adj:pl:gen:f:pos
i	i	conj
Zarządzania	zarządzanie	subst:sg:gen:n
,	,	interp
recenzje	recenzja	subst:pl:acc:f
dorobku	dorobek	subst:sg:gen:m3
nadesłali	nadesłać	praet:pl:m1:perf
byli	były	adj:pl:nom:m1:pos
ministrowie	minister	subst:pl:nom:m1
spraw	sprawa	subst:pl:gen:f
zagranicznych	zagraniczny	adj:pl:gen:f:pos
RP	RP	subst:sg:gen:f
prof	profesor	brev:pun
.	.	interp
Krzysztof	Krzysztof	subst:sg:nom:m1
Skubiszewski	Skubiszewski	subst:sg:nom:m1
i	i	conj
prof	profesor	brev:pun
.	.	interp
Dariusz	Dariusz	subst:sg:nom:m1
Rosati	Rosati	subst:sg:nom:m1
oraz	oraz	conj
prof	profesor	brev:pun
.	.	interp
Włodzimierz	Włodzimierz	subst:sg:nom:m1
Stępiński	Stępiński	subst:sg:nom:m1
,	,	interp
historyk	historyk	subst:sg:nom:m1
,	,	interp
znawca	znawca	subst:sg:nom:m1
problematyki	problematyka	subst:sg:gen:f
niemieckiej	niemiecki	adj:sg:gen:f:pos
.	.	interp
W	w	prep:loc:nwok
szkołach	szkoła	subst:pl:loc:f
wyższych	wysoki	adj:pl:loc:f:com
trwają	trwać	fin:pl:ter:imperf
wybory	wybory	subst:pl:nom:n
władz	władza	subst:pl:gen:f
.	.	interp
Wczoraj	wczoraj	adv
wybrano	wybrać	imps:perf
dziekanów	dziekan	subst:pl:gen:m1
dwóch	dwa	num:pl:acc:m1:rec
Uniwersytetu	uniwersytet	subst:sg:gen:m3
Szczecińskiego	szczeciński	adj:sg:gen:m3:pos
.	.	interp
Dziekanem	dziekan	subst:sg:inst:m1
Wydziału	wydział	subst:sg:gen:m3
Zarządzania	zarządzanie	subst:sg:gen:n
i	i	conj
Ekonomiki	ekonomika	subst:sg:gen:f
Usług	usługa	subst:pl:gen:f
został	zostać	praet:sg:m1:perf
ponownie	ponownie	adv:pos
prof	profesor	brev:pun
.	.	interp
Józef	Józef	subst:sg:nom:m1
Perenc	Perenc	subst:sg:nom:m1
.	.	interp
Prof	profesor	brev:pun
.	.	interp
Perenc	Perenc	subst:sg:nom:m1
jest	być	fin:sg:ter:imperf
również	również	qub
kierownikiem	kierownik	subst:sg:inst:m1
Katedry	katedra	subst:sg:gen:f
Marketingu	marketing	subst:sg:gen:m3
Usług	usługa	subst:pl:gen:f
.	.	interp
Dziekanem	dziekan	subst:sg:inst:m1
Wydziału	wydział	subst:sg:gen:m3
Humanistycznego	humanistyczny	adj:sg:gen:m3:pos
został	zostać	praet:sg:m1:perf
prof	profesor	brev:pun
.	.	interp
Adam	Adam	subst:sg:nom:m1
Wątor	Wątor	subst:sg:nom:m1
,	,	interp
dotychczasowy	dotychczasowy	adj:sg:nom:m1:pos
prodziekan	prodziekan	subst:sg:nom:m1
ds	do spraw	brev:pun
.	.	interp
kształcenia	kształcenie	subst:sg:gen:n
i	i	conj
organizacji	organizacja	subst:sg:gen:f
.	.	interp
Prof	profesor	brev:pun
.	.	interp
Wątor	Wątor	subst:sg:nom:m1
,	,	interp
który	który	adj:sg:nom:m1:pos
był	być	praet:sg:m1:imperf
jednym	jeden	adj:sg:inst:m1:pos
z	z	prep:gen:nwok
dwóch	dwa	num:pl:gen:m1:congr
kandydatów	kandydat	subst:pl:gen:m1
,	,	interp
kieruje	kierować	fin:sg:ter:imperf
Zakładem	zakład	subst:sg:inst:m3
Dydaktyki	dydaktyka	subst:sg:gen:f
Historii	historia	subst:sg:gen:f
.	.	interp
Do	do	prep:gen
sądu	sąd	subst:sg:gen:m3
federalnego	federalny	adj:sg:gen:m3:pos
w	w	prep:loc:nwok
Brooklynie	Brooklyn	subst:sg:loc:m3
został	zostać	praet:sg:m3:perf
wczoraj	wczoraj	adv
wniesiony	wnieść	ppas:sg:nom:m3:perf:aff
pozew	pozew	subst:sg:nom:m3
z	z	prep:inst:nwok
żądaniem	żądać	ger:sg:inst:n:imperf:aff
odszkodowań	odszkodowanie	subst:pl:gen:n
dla	dla	prep:gen
35	35	num:pl:gen:m3:congr
milionów	milion	subst:pl:gen:m3
potomków	potomek	subst:pl:gen:m1
niewolników	niewolnik	subst:pl:gen:m1
w	w	prep:loc:nwok
Stanach	Stany	subst:pl:loc:n
Zjednoczonych	Zjednoczony	adj:pl:loc:n:pos
.	.	interp
W	w	prep:loc:nwok
pozwie	pozew	subst:sg:loc:m3
podkreśla	podkreślać	fin:sg:ter:imperf
się	się	qub
,	,	interp
że	że	comp
niewolnictwo	niewolnictwo	subst:sg:nom:n
było	być	praet:sg:n:imperf
"	"	interp
niemoralnym	niemoralny	adj:sg:inst:n:pos
i	i	conj
nieludzkim	nieludzki	adj:sg:inst:n:pos
"	"	interp
pozbawianiem	pozbawiać	ger:sg:inst:n:imperf:aff
Afrykanów	Afrykanin	subst:pl:gen:m1
prawa	prawo	subst:sg:gen:n
do	do	prep:gen
"	"	interp
życia	żyć	ger:sg:gen:n:imperf:aff
,	,	interp
wolności	wolność	subst:sg:gen:f
,	,	interp
obywatelstwa	obywatelstwo	subst:sg:gen:n
,	,	interp
spuścizny	spuścizna	subst:sg:gen:f
kulturalnej	kulturalny	adj:sg:gen:f:pos
i	i	conj
do	do	prep:gen
owoców	owoc	subst:pl:gen:m3
ich	on	ppron3:pl:gen:m1:ter:akc:npraep
pracy	praca	subst:sg:gen:f
"	"	interp
.	.	interp
Mimo	mimo	prep:gen
że	że	comp
nadal	nadal	adv
nie	nie	qub
wiadomo	wiadomo	pred
,	,	interp
jak	jak	adv:pos
będzie	być	bedzie:sg:ter:imperf
wybierany	wybierać	ppas:sg:nom:m1:imperf:aff
przyszły	przyszły	adj:sg:nom:m1:pos
prezydent	prezydent	subst:sg:nom:m1
miasta	miasto	subst:sg:gen:n
,	,	interp
salony	salon	subst:pl:nom:m3
polityczne	polityczny	adj:pl:nom:m3:pos
Szczecina	Szczecin	subst:sg:gen:m3
są	być	fin:pl:ter:imperf
pełne	pełny	adj:pl:nom:m3:pos
spekulacji	spekulacja	subst:pl:gen:f
na	na	prep:acc
ten	ten	adj:sg:acc:m3:pos
temat	temat	subst:sg:acc:m3
.	.	interp
Jak	jak	adv:pos
dotąd	dotąd	adv
jednak	jednak	conj
żadne	żaden	adj:sg:nom:n:pos
z	z	prep:gen:nwok
ugrupowań	ugrupowanie	subst:pl:gen:n
nie	nie	qub
zdecydowało	zdecydować	praet:sg:n:perf
się	się	qub
oficjalnie	oficjalnie	adv:pos
przedstawić	przedstawić	inf:perf
swojego	swój	adj:sg:gen:m1:pos
kandydata	kandydat	subst:sg:gen:m1
.	.	interp
Większość	większość	subst:sg:nom:f
boi	bać	fin:sg:ter:imperf
się	się	qub
"	"	interp
spalenia	spalić	ger:sg:gen:n:perf:aff
"	"	interp
startującego	startować	pact:sg:gen:m1:imperf:aff
,	,	interp
inni	inny	adj:pl:nom:m1:pos
wciąż	wciąż	adv
nie	nie	qub
mają	mieć	fin:pl:ter:imperf
pomysłu	pomysł	subst:sg:gen:m3
.	.	interp
-	-	interp
Jaka	jaki	adj:sg:nom:f:pos
jest	być	fin:sg:ter:imperf
przyczyna	przyczyna	subst:sg:nom:f
tego	ten	adj:sg:gen:m3:pos
stanu	stan	subst:sg:gen:m3
?	?	interp
-	-	interp
W	w	prep:loc:nwok
naszej	nasz	adj:sg:loc:f:pos
ocenie	ocena	subst:sg:loc:f
to	to	pred
konflikt	konflikt	subst:sg:nom:m3
interesów	interes	subst:pl:gen:m3
z	z	prep:inst:nwok
Polską	polski	adj:sg:inst:f:pos
Żeglugą	żegluga	subst:sg:inst:f
Bałtycką	bałtycki	adj:sg:inst:f:pos
.	.	interp
Od	od	prep:gen:nwok
7	7	num:pl:gen:m3:congr
lat	rok	subst:pl:gen:m3
nie	nie	qub
możemy	móc	fin:pl:pri:imperf
z	z	prep:inst:nwok
tą	ten	adj:sg:inst:f:pos
spółką	spółka	subst:sg:inst:f
znaleźć	znaleźć	inf:perf
wspólnej	wspólny	adj:sg:gen:f:pos
formuły	formuła	subst:sg:gen:f
współpracy	współpraca	subst:sg:gen:f
,	,	interp
której	który	adj:sg:gen:f:pos
celem	cel	subst:sg:inst:m3
była	być	praet:sg:f:imperf
by	by	qub
optymalizacja	optymalizacja	subst:sg:nom:f
efektów	efekt	subst:pl:gen:m3
prowadzonej	prowadzić	ppas:sg:gen:f:imperf:aff
działalności	działalność	subst:sg:gen:f
.	.	interp
Nie	nie	qub
twierdzę	twierdzić	fin:sg:pri:imperf
,	,	interp
że	że	comp
prowadzimy	prowadzić	fin:pl:pri:imperf
wojnę	wojna	subst:sg:acc:f
promową	promowy	adj:sg:acc:f:pos
.	.	interp
Nie	nie	qub
dopracowali	dopracować	praet:pl:m1:perf
śmy	być	aglt:pl:pri:imperf:nwok
się	się	qub
jednak	jednak	conj
rozwiązań	rozwiązanie	subst:pl:gen:n
,	,	interp
które	który	adj:pl:nom:n:pos
pozwoliły	pozwolić	praet:pl:n:perf
by	by	qub
na	na	prep:acc
zwiększenie	zwiększyć	ger:sg:acc:n:perf:aff
zdolności	zdolność	subst:sg:gen:f
przewozowej	przewozowy	adj:sg:gen:f:pos
,	,	interp
przy	przy	prep:loc
jednoczesnym	jednoczesny	adj:sg:loc:n:pos
uzgodnieniu	uzgodnić	ger:sg:loc:n:perf:aff
rozkładów	rozkład	subst:pl:gen:m3
rejsów	rejs	subst:pl:gen:m3
,	,	interp
które	który	adj:pl:nom:m3:pos
odpowiadały	odpowiadać	praet:pl:m3:imperf
by	by	qub
oczekiwaniom	oczekiwanie	subst:pl:dat:n
klientów	klient	subst:pl:gen:m1
.	.	interp
Na	na	prep:acc
rynek	rynek	subst:sg:acc:m3
trafia	trafiać	fin:sg:ter:imperf
MasterCard	MasterCard	subst:sg:nom:f
-	-	interp
Karta	karta	subst:sg:nom:f
Dystrybutora	dystrybutor	subst:sg:gen:m1
,	,	interp
nowa	nowy	adj:sg:nom:f:pos
karta	karta	subst:sg:nom:f
Eurocard	Eurocard	subst:sg:nom:m3
służąca	służyć	pact:sg:nom:f:imperf:aff
do	do	prep:gen
rozliczeń	rozliczenie	subst:pl:gen:n
między	między	prep:inst
firmami	firma	subst:pl:inst:f
.	.	interp
Nowy	nowy	adj:sg:nom:m3:pos
system	system	subst:sg:nom:m3
wyróżnia	wyróżniać	fin:sg:ter:imperf
się	się	qub
tym	to	subst:sg:inst:n
,	,	interp
że	że	comp
jego	on	ppron3:sg:gen:m3:ter:akc:npraep
inicjatorami	inicjator	subst:pl:inst:m1
są	być	fin:pl:ter:imperf
dystrybutorzy	dystrybutor	subst:pl:nom:m1
szybko	szybko	adv:pos
zbywalnych	zbywalny	adj:pl:gen:m3:pos
,	,	interp
niedrogich	niedrogi	adj:pl:gen:m3:pos
towarów	towar	subst:pl:gen:m3
sprzedawanych	sprzedawać	ppas:pl:gen:m3:imperf:aff
w	w	prep:loc:nwok
dużych	duży	adj:pl:loc:f:pos
ilościach	ilość	subst:pl:loc:f
,	,	interp
np	na przykład	brev:pun
.	.	interp
dostawcy	dostawca	subst:pl:nom:m1
zaopatrujący	zaopatrywać	pact:pl:nom:m1:imperf:aff
małe	mały	adj:pl:acc:m3:pos
sklepy	sklep	subst:pl:acc:m3
spożywcze	spożywczy	adj:pl:acc:m3:pos
lub	lub	conj
apteki	apteka	subst:pl:acc:f
.	.	interp
Oferują	oferować	fin:pl:ter:imperf
oni	on	ppron3:pl:nom:m1:ter:akc:npraep
nową	nowy	adj:sg:acc:f:pos
kartę	karta	subst:sg:acc:f
właścicielom	właściciel	subst:pl:dat:m1
sklepów	sklep	subst:pl:gen:m3
,	,	interp
do	do	prep:gen
których	który	adj:pl:gen:m3:pos
regularnie	regularnie	adv:pos
dostarczają	dostarczać	fin:pl:ter:imperf
towar	towar	subst:sg:acc:m3
,	,	interp
zmniejszając	zmniejszać	pcon:imperf
zapotrzebowanie	zapotrzebowanie	subst:sg:acc:n
na	na	prep:acc
gotówkę	gotówka	subst:sg:acc:f
lub	lub	conj
obrót	obrót	subst:sg:acc:m3
czekami	czek	subst:pl:inst:m3
.	.	interp
W	w	prep:loc:nwok
NOCY	noc	subst:sg:loc:f
z	z	prep:gen:nwok
soboty	sobota	subst:sg:gen:f
na	na	prep:acc
niedzielę	niedziela	subst:sg:acc:f
nastąpi	nastąpić	fin:sg:ter:perf
w	w	prep:loc:nwok
Polsce	Polska	subst:sg:loc:f
zmiana	zmiana	subst:sg:nom:f
czasu	czas	subst:sg:gen:m3
,	,	interp
z	z	prep:gen:nwok
zimowego	zimowy	adj:sg:gen:m3:pos
na	na	prep:acc
letni	letni	adj:sg:acc:m3:pos
(	(	interp
wschodnioeuropejski	wschodnioeuropejski	adj:sg:acc:m3:pos
)	)	interp
.	.	interp
31	31	adj:sg:gen:m3:pos
marca	marzec	subst:sg:gen:m3
wskazówki	wskazówka	subst:pl:acc:f
zegarów	zegar	subst:pl:gen:m3
przesuniemy	przesunąć	fin:pl:pri:perf
z	z	prep:gen:nwok
godziny	godzina	subst:sg:gen:f
2	2	adj:sg:gen:f:pos
.	.	interp
00	00	num:pl:nom:f:rec
na	na	prep:acc
3	3	adj:sg:acc:f:pos
.	.	interp
00	00	num:pl:nom:f:rec
,	,	interp
która	który	adj:sg:nom:f:pos
będzie	być	bedzie:sg:ter:imperf
godziną	godzina	subst:sg:inst:f
początkową	początkowy	adj:sg:inst:f:pos
czasu	czas	subst:sg:gen:m3
letniego	letni	adj:sg:gen:m3:pos
.	.	interp
Będzie	być	bedzie:sg:ter:imperf
on	on	ppron3:sg:nom:m3:ter:akc:npraep
obowiązywać	obowiązywać	inf:imperf
do	do	prep:gen
27	27	adj:sg:gen:m3:pos
października	październik	subst:sg:gen:m3
2002	2002	adj:sg:gen:m3:pos
r	rok	brev:pun
.	.	interp
,	,	interp
kiedy	kiedy	adv
powrócimy	powrócić	fin:pl:pri:perf
do	do	prep:gen
czasu	czas	subst:sg:gen:m3
zimowego	zimowy	adj:sg:gen:m3:pos
,	,	interp
czyli	czyli	conj
do	do	prep:gen
środkowoeuropejskiego	środkowoeuropejski	adj:sg:gen:m3:pos
.	.	interp
Czas	czas	subst:sg:nom:m3
letni	letni	adj:sg:nom:m3:pos
w	w	prep:loc:nwok
Polsce	Polska	subst:sg:loc:f
wprowadzany	wprowadzać	ppas:sg:nom:m3:imperf:aff
jest	być	fin:sg:ter:imperf
rozporządzeniem	rozporządzenie	subst:sg:inst:n
Prezesa	prezes	subst:sg:gen:m1
Rady	rada	subst:sg:gen:f
Ministrów	minister	subst:pl:gen:m1
z	z	prep:gen:nwok
11	11	adj:sg:gen:m3:pos
grudnia	grudzień	subst:sg:gen:m3
2001	2001	adj:sg:gen:m3:pos
r	rok	brev:pun
.	.	interp
-	-	interp
Dzisiaj	dzisiaj	adv
PŻB	PŻB	subst:sg:nom:f
eksploatuje	eksploatować	fin:sg:ter:imperf
4	4	num:pl:acc:m3:congr
promy	prom	subst:pl:acc:m3
.	.	interp
Firma	firma	subst:sg:nom:f
ta	ten	adj:sg:nom:f:pos
ciągle	ciągle	adv:pos
ma	mieć	fin:sg:ter:imperf
ambicję	ambicja	subst:sg:acc:f
bycia	być	ger:sg:gen:n:imperf:aff
postrzeganym	postrzegać	ppas:sg:inst:m1:imperf:aff
jako	jako	prep:nom
lider	lider	subst:sg:nom:m1
na	na	prep:loc
rynku	rynek	subst:sg:loc:m3
.	.	interp
My	my	ppron12:pl:nom:m1:pri
operujemy	operować	fin:pl:pri:imperf
3	3	num:pl:inst:f:congr
jednostkami	jednostka	subst:pl:inst:f
.	.	interp
Szacuję	szacować	fin:sg:pri:imperf
wartość	wartość	subst:sg:acc:f
floty	flota	subst:sg:gen:f
kołobrzeskiego	kołobrzeski	adj:sg:gen:m1:pos
armatora	armator	subst:sg:gen:m1
na	na	prep:acc
ok	około	brev:pun
.	.	interp
20	20	num:pl:acc:m3:rec
mln	milion	brev:npun
USD	USD	subst:pl:gen:m2
,	,	interp
podczas	podczas	prep:gen
gdy	gdy	adv
w	w	prep:loc:nwok
przypadku	przypadek	subst:sg:loc:m3
naszych	nasz	adj:pl:gen:m3:pos
promów	prom	subst:pl:gen:m3
jest	być	fin:sg:ter:imperf
ona	on	ppron3:sg:nom:f:ter:akc:npraep
dwukrotnie	dwukrotnie	adv:pos
wyższa	wysoki	adj:sg:nom:f:com
.	.	interp
Chodzi	chodzić	fin:sg:ter:imperf
o	o	prep:acc
to	to	subst:sg:acc:n
,	,	interp
aby	aby	comp
się	się	qub
zastanowić	zastanowić	inf:perf
,	,	interp
co	co	subst:sg:acc:n
można	można	pred
z	z	prep:inst:nwok
tymi	ten	adj:pl:inst:m3:pos
statkami	statek	subst:pl:inst:m3
zrobić	zrobić	inf:perf
.	.	interp
Stany	Stany	subst:pl:nom:n
Zjednoczone	Zjednoczony	adj:pl:nom:n:pos
powinny	powinien	winien:pl:n:imperf
zagwarantować	zagwarantować	inf:perf
Izraelowi	Izrael	subst:sg:dat:m3
prawo	prawo	subst:sg:acc:n
odmowy	odmowa	subst:sg:gen:f
wpuszczenia	wpuścić	ger:sg:gen:n:perf:aff
Jasera	Jaser	subst:sg:gen:m1
Arafata	Arafat	subst:sg:gen:m1
z	z	prep:inst:nwok
powrotem	powrót	subst:sg:inst:m3
do	do	prep:gen
kraju	kraj	subst:sg:gen:m3
.	.	interp
To	to	pred
warunek	warunek	subst:sg:nom:m3
pozwolenia	pozwolić	ger:sg:gen:n:perf:aff
mu	on	ppron3:sg:dat:m1:ter:nakc:npraep
na	na	prep:acc
wyjazd	wyjazd	subst:sg:acc:m3
na	na	prep:acc
szczyt	szczyt	subst:sg:acc:m3
arabski	arabski	adj:sg:acc:m3:pos
w	w	prep:loc:nwok
Bejrucie	Bejrut	subst:sg:loc:m3
-	-	interp
powiedział	powiedzieć	praet:sg:m1:perf
wczoraj	wczoraj	adv
izraelski	izraelski	adj:sg:nom:m1:pos
premier	premier	subst:sg:nom:m1
Ariel	Ariel	subst:sg:nom:m1
Szaron	Szaron	subst:sg:nom:m1
.	.	interp
Wcześniej	wcześnie	adv:com
Szaron	Szaron	subst:sg:nom:m1
oświadczył	oświadczyć	praet:sg:m1:perf
,	,	interp
że	że	comp
nie	nie	qub
zostały	zostać	praet:pl:m3:perf
spełnione	spełnić	ppas:pl:nom:m3:perf:aff
warunki	warunek	subst:pl:nom:m3
,	,	interp
od	od	prep:gen:nwok
których	który	adj:pl:gen:m3:pos
jego	on	ppron3:sg:gen:m1:ter:akc:npraep
kraj	kraj	subst:sg:nom:m3
uzależniał	uzależniać	praet:sg:m3:imperf
zgodę	zgoda	subst:sg:acc:f
na	na	prep:acc
wyjazd	wyjazd	subst:sg:acc:m3
przywódcy	przywódca	subst:sg:gen:m1
Palestyńczyków	Palestyńczyk	subst:pl:gen:m1
Jasera	Jaser	subst:sg:gen:m1
Arafata	Arafat	subst:sg:gen:m1
na	na	prep:acc
szczyt	szczyt	subst:sg:acc:m3
.	.	interp
Dwudniowe	dwudniowy	adj:sg:nom:n:pos
spotkanie	spotkanie	subst:sg:nom:n
państw	państwo	subst:pl:gen:n
Ligi	liga	subst:sg:gen:f
Arabskiej	arabski	adj:sg:gen:f:pos
rozpocznie	rozpocząć	fin:sg:ter:perf
się	się	qub
w	w	xxx
dziś	dziś	adv
.	.	interp
