Były	były	adj:sg:nom:m1:pos
partyzancki	partyzancki	adj:sg:nom:m1:pos
dowódca	dowódca	subst:sg:nom:m1
Xanana	Xanana	subst:sg:nom:m1
Gusmao	Gusmao	subst:sg:nom:m1
został	zostać	praet:sg:m1:perf
triumfalnie	triumfalnie	adv:pos
wybrany	wybrać	ppas:sg:nom:m1:perf:aff
na	na	prep:acc
prezydenta	prezydent	subst:sg:acc:m1
Timoru	Timor	subst:sg:gen:m3
Wschodniego	Wschodni	adj:sg:gen:m3:pos
,	,	interp
nowego	nowy	adj:sg:gen:n:pos
państwa	państwo	subst:sg:gen:n
,	,	interp
które	który	adj:sg:nom:n:pos
wyłania	wyłaniać	fin:sg:ter:imperf
się	się	qub
z	z	prep:gen:nwok
ruin	ruina	subst:pl:gen:f
i	i	conj
biedy	bieda	subst:sg:gen:f
na	na	prep:loc
obszarze	obszar	subst:sg:loc:m3
,	,	interp
należącym	należeć	pact:sg:loc:m3:imperf:aff
jeszcze	jeszcze	qub
trzy	trzy	num:pl:acc:m3:congr
lata	rok	subst:pl:acc:m3
temu	temu	prep:acc
nieformalnie	nieformalnie	adv:pos
do	do	prep:gen
Indonezji	Indonezja	subst:sg:gen:f
.	.	interp
W	w	prep:acc:nwok
środę	środa	subst:sg:acc:f
potwierdzono	potwierdzić	imps:perf
jego	on	ppron3:sg:gen:m1:ter:akc:npraep
przytłaczające	przytłaczający	adj:sg:acc:n:pos
zwycięstwo	zwycięstwo	subst:sg:acc:n
83	83	num:pl:inst:m3:congr
procentami	procent	subst:pl:inst:m3
głosów	głos	subst:pl:gen:m3
w	w	prep:loc:nwok
wyborach	wybory	subst:pl:loc:n
,	,	interp
które	który	adj:pl:nom:n:pos
odbyły	odbyć	praet:pl:n:perf
się	się	qub
w	w	prep:acc:nwok
ostatnią	ostatni	adj:sg:acc:f:pos
niedzielę	niedziela	subst:sg:acc:f
.	.	interp
