Główne	główny	adj:pl:nom:f:pos
uroczystości	uroczystość	subst:pl:nom:f
z	z	prep:gen:nwok
okazji	okazja	subst:sg:gen:f
rocznicy	rocznica	subst:sg:gen:f
Konstytucji	konstytucja	subst:sg:gen:f
rozpoczęły	rozpocząć	praet:pl:f:perf
się	się	qub
od	od	prep:gen:nwok
złożenia	złożyć	ger:sg:gen:n:perf:aff
kwiatów	kwiat	subst:pl:gen:m3
pod	pod	prep:inst:nwok
pomnikiem	pomnik	subst:sg:inst:m3
42	42	adj:sg:gen:m3:pos
pułku	pułk	subst:sg:gen:m3
piechoty	piechota	subst:sg:gen:f
w	w	prep:loc:nwok
Parku	Park	subst:sg:loc:m3
Zwierzynieckim	Zwierzyniecki	adj:sg:loc:m3:pos
.	.	interp
Przed	przed	prep:inst:nwok
południem	południe	subst:sg:inst:n
w	w	prep:loc:nwok
Katedrze	katedra	subst:sg:loc:f
WNMP	WNMP	subst:sg:gen:n
metropolita	metropolita	subst:sg:nom:m1
białostocki	białostocki	adj:sg:nom:m1:pos
abp	arcybiskup	brev:npun
Stanisław	Stanisław	subst:sg:nom:m1
Szymecki	Szymecki	subst:sg:nom:m1
celebrował	celebrować	praet:sg:m1:imperf
mszę	msza	subst:sg:acc:f
św	święty	brev:pun
.	.	interp
w	w	prep:loc:nwok
intencji	intencja	subst:sg:loc:f
Ojczyzny	ojczyzna	subst:sg:gen:f
.	.	interp
Jej	on	ppron3:sg:gen:f:ter:akc:npraep
uczestnicy	uczestnik	subst:pl:nom:m1
z	z	prep:inst:nwok
pocztami	poczet	subst:pl:inst:m3
sztandarowymi	sztandarowy	adj:pl:inst:m3:pos
i	i	conj
orkiestrą	orkiestra	subst:sg:inst:f
18	18	adj:sg:gen:f:pos
.	.	interp
Białostockiej	białostocki	adj:sg:gen:f:pos
Brygady	brygada	subst:sg:gen:f
Zmechanizowanej	zmechanizować	ppas:sg:gen:f:perf:aff
przeszli	przejść	praet:pl:m1:perf
pod	pod	prep:acc:nwok
pomnik	pomnik	subst:sg:acc:m3
marszałka	marszałek	subst:sg:gen:m1
Józefa	Józef	subst:sg:gen:m1
Piłsudskiego	Piłsudski	subst:sg:gen:m1
