Jedno	jeden	adj:sg:nom:n:pos
z	z	prep:gen:nwok
japońskich	japoński	adj:pl:gen:n:pos
przedsiębiorstw	przedsiębiorstwo	subst:pl:gen:n
kolejowych	kolejowy	adj:pl:gen:n:pos
znalazło	znaleźć	praet:sg:n:perf
na	na	prep:acc
to	to	subst:sg:acc:n
sposób	sposób	subst:sg:acc:m3
.	.	interp
Przejazdy	przejazd	subst:pl:acc:m3
kolejowe	kolejowy	adj:pl:acc:m3:pos
pomalowano	pomalować	imps:perf
na	na	prep:acc
przyjemny	przyjemny	adj:sg:acc:m3:pos
dla	dla	prep:gen
oka	oko	subst:sg:gen:n
błękitny	błękitny	adj:sg:acc:m3:pos
kolor	kolor	subst:sg:acc:m3
(	(	interp
co	co	subst:sg:nom:n
ma	mieć	fin:sg:ter:imperf
poprawić	poprawić	inf:perf
nastrój	nastrój	subst:sg:acc:m3
i	i	conj
odpędzić	odpędzić	inf:perf
czarne	czarny	adj:pl:acc:f:pos
myśli	myśl	subst:pl:acc:f
)	)	interp
,	,	interp
a	a	conj
na	na	prep:loc
peronach	peron	subst:pl:loc:m3
ustawiono	ustawić	imps:perf
lustra	lustro	subst:pl:acc:n
(	(	interp
które	który	adj:pl:nom:n:pos
mają	mieć	fin:pl:ter:imperf
zachęcać	zachęcać	inf:imperf
do	do	prep:gen
spojrzenia	spojrzeć	ger:sg:gen:n:perf:aff
za	za	prep:acc
siebie	siebie	siebie:acc
i	i	conj
zastanowienia	zastanowić	ger:sg:gen:n:perf:aff
,	,	interp
czy	czy	qub
warto	warto	pred
targnąć	targnąć	inf:perf
się	się	qub
na	na	prep:acc
życie	życie	subst:sg:acc:n
)	)	interp
.	.	interp
