Uroczysta	uroczysty	adj:sg:nom:f:pos
msza	msza	subst:sg:nom:f
święta	święty	adj:sg:nom:f:pos
w	w	prep:loc:nwok
intencji	intencja	subst:sg:loc:f
reprezentacji	reprezentacja	subst:sg:gen:f
Polski	Polska	subst:sg:gen:f
w	w	prep:loc:nwok
piłce	piłka	subst:sg:loc:f
nożnej	nożny	adj:sg:loc:f:pos
została	zostać	praet:sg:f:perf
odprawiona	odprawić	ppas:sg:nom:f:perf:aff
w	w	prep:acc:nwok
piątek	piątek	subst:sg:acc:m3
w	w	prep:loc:nwok
Kazimierzu	Kazimierz	subst:sg:loc:m3
Dolnym	Dolny	adj:sg:loc:m3:pos
.	.	interp
Akurat	akurat	qub
wtedy	wtedy	adv
,	,	interp
gdy	gdy	adv
kadrowicze	kadrowicz	subst:pl:nom:m1
rozpakowywali	rozpakowywać	praet:pl:m1:imperf
w	w	prep:loc:nwok
Warszawie	Warszawa	subst:sg:loc:f
swój	swój	adj:sg:acc:m3:pos
sprzęt	sprzęt	subst:sg:acc:m3
po	po	prep:loc
powrocie	powrót	subst:sg:loc:m3
ze	z	prep:gen:wok
zgrupowania	zgrupowanie	subst:sg:gen:n
w	w	prep:loc:nwok
Barsinghausen	Barsinghausen	subst:sg:loc:n
,	,	interp
w	w	prep:loc:nwok
kościele	kościół	subst:sg:loc:m3
w	w	prep:loc:nwok
Kazimierzu	Kazimierz	subst:sg:loc:m3
zebrał	zebrać	praet:sg:m3:perf
się	się	qub
tłum	tłum	subst:sg:nom:m3
wiernych	wierny	subst:pl:gen:m1
,	,	interp
który	który	adj:sg:nom:m3:pos
modlił	modlić	praet:sg:m3:imperf
się	się	qub
o	o	prep:acc
powodzenie	powodzenie	subst:sg:acc:n
naszej	nasz	adj:sg:gen:f:pos
drużyny	drużyna	subst:sg:gen:f
w	w	prep:loc:nwok
zbliżających	zbliżać	pact:pl:loc:n:imperf:aff
się	się	qub
mistrzostwach	mistrzostwa	subst:pl:loc:n
świata	świat	subst:sg:gen:m3
.	.	interp
