Do	do	prep:gen
gabinetu	gabinet	subst:sg:gen:m3
Ryszarda	Ryszard	subst:sg:gen:m1
Kalisza	Kalisz	subst:sg:gen:m1
,	,	interp
pełniącego	pełnić	pact:sg:gen:m1:imperf:aff
obowiązki	obowiązek	subst:pl:acc:m3
szefa	szef	subst:sg:gen:m1
Kancelarii	kancelaria	subst:sg:gen:f
Prezydenta	prezydent	subst:sg:gen:m1
RP	RP	subst:sg:gen:f
,	,	interp
próbowała	próbować	praet:sg:f:imperf
wtargnąć	wtargnąć	inf:perf
kobieta	kobieta	subst:sg:nom:f
uzbrojona	uzbroić	ppas:sg:nom:f:perf:aff
w	w	prep:acc:nwok
dwa	dwa	num:pl:acc:m3:congr
noże	nóż	subst:pl:acc:m3
.	.	interp
Janusz	Janusz	subst:sg:nom:m1
Walecki	Walecki	subst:sg:nom:m1
,	,	interp
wicedyrektor	wicedyrektor	subst:sg:nom:m1
biura	biuro	subst:sg:gen:n
informacji	informacja	subst:sg:gen:f
i	i	conj
komunikacji	komunikacja	subst:sg:gen:f
społecznej	społeczny	adj:sg:gen:f:pos
w	w	prep:loc:nwok
kancelarii	kancelaria	subst:sg:loc:f
,	,	interp
powiedział	powiedzieć	praet:sg:m1:perf
nam	my	ppron12:pl:dat:m1:pri
,	,	interp
że	że	comp
ministrowi	minister	subst:sg:dat:m1
nic	nic	subst:sg:nom:n
się	się	qub
nie	nie	qub
stało	stać	praet:sg:n:perf
,	,	interp
gdyż	gdyż	comp
napastniczce	napastniczka	subst:sg:dat:f
nie	nie	qub
udało	udać	praet:sg:n:perf
się	się	qub
nawet	nawet	qub
sforsować	sforsować	inf:perf
drzwi	drzwi	subst:pl:gen:n
.	.	interp
