BAZA	baza	subst:sg:nom:f
wprowadziła	wprowadzić	praet:sg:f:perf
na	na	prep:acc
rynek	rynek	subst:sg:acc:m3
dwie	dwa	num:pl:acc:f:congr
nowe	nowy	adj:pl:acc:f:pos
płyty	płyta	subst:pl:acc:f
główne	główny	adj:pl:acc:f:pos
Lucky	Lucky	subst:sg:nom:f
Star	Star	subst:sg:nom:f
,	,	interp
przeznaczone	przeznaczyć	ppas:pl:acc:f:perf:aff
do	do	prep:gen
współpracy	współpraca	subst:sg:gen:f
z	z	prep:inst:nwok
procesorami	procesor	subst:pl:inst:m3
Intel	Intel	subst:sg:nom:m3
Pentium	Pentium	subst:sg:nom:n
II	II	num:pl:nom:n:congr
ERROR :		:interp
6LX2	6LX2	subst:sg:nom:m3
i	i	conj
6 ABX2	6ABX2	subst:sg:nom:m3
.	.	interp
W	w	prep:loc:nwok
konstrukcji	konstrukcja	subst:sg:loc:f
pierwszej	pierwszy	adj:sg:gen:f:pos
z	z	prep:gen:nwok
nich	on	ppron3:pl:gen:f:ter:akc:praep
wykorzystano	wykorzystać	imps:perf
popularny	popularny	adj:sg:acc:m3:pos
chipset	chipset	subst:sg:acc:m3
Intel	Intel	subst:sg:nom:m3
440	440	subst:sg:nom:m3
LX	LX	subst:sg:nom:m3
,	,	interp
gwarantujący	gwarantować	pact:sg:acc:m3:imperf:aff
dobre	dobry	adj:pl:acc:m3:pos
osiągi	osiąg	subst:pl:acc:m3
wydajnościowe	wydajnościowy	adj:pl:acc:m3:pos
,	,	interp
zwłaszcza	zwłaszcza	qub
przy	przy	prep:loc
korzystaniu	korzystać	ger:sg:loc:n:imperf:aff
z	z	prep:gen:nwok
karty	karta	subst:sg:gen:f
graficznej	graficzny	adj:sg:gen:f:pos
ze	z	prep:inst:wok
złączem	złącze	subst:sg:inst:n
AGP	AGP	subst:sg:nom:n
.	.	interp
