Podopieczni	podopieczny	subst:pl:nom:m1
Leo	Leo	subst:sg:gen:m1
Beenhakkera	Beenhakker	subst:sg:gen:m1
w	w	prep:loc:nwok
obecnym	obecny	adj:sg:loc:m3:pos
sezonie	sezon	subst:sg:loc:m3
nadzwyczaj	nadzwyczaj	adv
skutecznie	skutecznie	adv:pos
gromadzą	gromadzić	fin:pl:ter:imperf
punkty	punkt	subst:pl:acc:m3
,	,	interp
dzięki	dzięki	prep:dat
czemu	co	subst:sg:dat:n
ich	on	ppron3:pl:gen:m1:ter:akc:npraep
przewaga	przewaga	subst:sg:nom:f
nad	nad	prep:inst:nwok
rywalami	rywal	subst:pl:inst:m1
nie	nie	qub
podlega	podlegać	fin:sg:ter:imperf
dyskusji	dyskusja	subst:sg:dat:f
.	.	interp
W	w	prep:loc:nwok
dotychczasowych	dotychczasowy	adj:pl:loc:n:pos
27	27	num:pl:loc:n:congr
spotkaniach	spotkanie	subst:pl:loc:n
tylko	tylko	qub
dwukrotnie	dwukrotnie	adv:pos
schodzili	schodzić	praet:pl:m1:imperf
z	z	prep:gen:nwok
boiska	boisko	subst:sg:gen:n
pokonani	pokonać	ppas:pl:nom:m1:perf:aff
,	,	interp
a	a	conj
wygrywali	wygrywać	praet:pl:m1:imperf
aż	aż	qub
21	21	num:pl:acc:m3:rec
razy	raz	subst:pl:gen:m3
(	(	interp
bilans	bilans	subst:sg:nom:m3
drugiego	drugi	adj:sg:gen:n:pos
Vitesse	Vitesse	subst:sg:gen:n
to	to	pred
ERROR :		:interp
16	16	num:pl:nom:m3:rec
-	-	interp
6	6	num:pl:nom:m3:rec
-	-	interp
5	5	num:pl:nom:m3:rec
)	)	interp
.	.	interp
