Jeden	jeden	adj:sg:nom:m2:pos
z	z	prep:gen:nwok
największych	duży	adj:pl:gen:m2:sup
węży	wąż	subst:pl:gen:m2
europejskich	europejski	adj:pl:gen:m2:pos
(	(	interp
150	150	num:pl:nom:m3:rec
-	-	interp
180	180	num:pl:nom:m3:rec
cm	centymetr	brev:npun
,	,	interp
nawet	nawet	qub
do	do	prep:gen
2	2	num:pl:gen:m3:congr
m	metr	brev:npun
)	)	interp
.	.	interp
Podobną	podobny	adj:sg:acc:f:pos
długość	długość	subst:sg:acc:f
ma	mieć	fin:sg:ter:imperf
wąż	wąż	subst:sg:nom:m2
Eskulapa	Eskulap	subst:sg:gen:m1
,	,	interp
jest	być	fin:sg:ter:imperf
jednak	jednak	conj
smuklejszy	smukły	adj:sg:nom:m2:com
.	.	interp
Charakterystyczny	charakterystyczny	adj:sg:nom:m3:pos
kształt	kształt	subst:sg:nom:m3
głowy	głowa	subst:sg:gen:f
o	o	prep:loc
wyraźnie	wyraźnie	adv:pos
skróconym	skrócony	adj:sg:loc:m3:pos
pysku	pysk	subst:sg:loc:m3
.	.	interp
Duże	duży	adj:pl:nom:n:pos
oczy	oko	subst:pl:nom:n
w	w	prep:loc:nwok
ciemnej	ciemny	adj:sg:loc:f:pos
obwódce	obwódka	subst:sg:loc:f
.	.	interp
Charakterystyczne	charakterystyczny	adj:pl:nom:f:pos
tarczki	tarczka	subst:pl:nom:f
nad	nad	prep:inst:nwok
oczami	oko	subst:pl:inst:n
.	.	interp
Żrenica	źrenica	subst:sg:nom:f
okrągła	okrągły	adj:sg:nom:f:pos
.	.	interp
Ubarwienie	ubarwienie	subst:sg:nom:n
od	od	prep:gen:nwok
jasnoszarego	jasnoszary	adj:sg:gen:n:pos
,	,	interp
poprzez	poprzez	prep:acc:nwok
oliwkowo	oliwkowy	adja
-	-	interp
brązowe	brązowy	adj:sg:acc:n:pos
do	do	prep:gen
szaroczarnego	szaroczarny	adj:sg:gen:n:pos
.	.	interp
Samce	samiec	subst:pl:nom:m2
zawsze	zawsze	adv
jednolicie	jednolicie	adv:pos
ubarwione	ubarwiony	adj:pl:nom:m2:pos
,	,	interp
samice	samica	subst:pl:nom:f
mogą	móc	fin:pl:ter:imperf
mieć	mieć	inf:imperf
ciemne	ciemny	adj:pl:acc:f:pos
plamki	plamka	subst:pl:acc:f
.	.	interp
