Ostatecznie	ostatecznie	adv:pos
prezes	prezes	subst:sg:nom:m1
zarządu	zarząd	subst:sg:gen:m3
PKP	PKP	subst:pl:gen:n
zagroził	zagrozić	praet:sg:m1:perf
wyciągnięciem	wyciągnąć	ger:sg:inst:n:perf:aff
konsekwencji	konsekwencja	subst:pl:gen:f
wobec	wobec	prep:gen
tych	ten	adj:pl:gen:m1:pos
,	,	interp
którzy	który	adj:pl:nom:m1:pos
nie	nie	qub
podejmą	podjąć	fin:pl:ter:perf
pracy	praca	subst:sg:gen:f
.	.	interp
Nie	nie	qub
wykluczył	wykluczyć	praet:sg:m1:perf
zwolnień	zwolnienie	subst:pl:gen:n
.	.	interp
Strajk	strajk	subst:sg:acc:m3
zawieszono	zawiesić	imps:perf
.	.	interp
Jego	on	ppron3:sg:gen:m3:ter:akc:npraep
przywódcę	przywódca	subst:sg:acc:m1
Jana	Jan	subst:sg:acc:m1
Zaborowskiego	Zaborowski	subst:sg:acc:m1
oskarżono	oskarżyć	imps:perf
o	o	prep:acc
zorganizowanie	zorganizować	ger:sg:acc:n:perf:aff
nielegalnego	nielegalny	adj:sg:gen:m3:pos
strajku	strajk	subst:sg:gen:m3
.	.	interp
Prokuratura	prokuratura	subst:sg:nom:f
zarzuciła	zarzucić	praet:sg:f:perf
mu	on	ppron3:sg:dat:m1:ter:nakc:npraep
,	,	interp
że	że	comp
naruszył	naruszyć	praet:sg:m1:perf
ustawę	ustawa	subst:sg:acc:f
o	o	prep:loc
rozwiązywaniu	rozwiązywać	ger:sg:loc:n:imperf:aff
sporów	spór	subst:pl:gen:m3
zbiorowych	zbiorowy	adj:pl:gen:m3:pos
,	,	interp
bo	bo	comp
nie	nie	qub
przekazał	przekazać	praet:sg:m1:perf
pracodawcy	pracodawca	subst:sg:dat:m1
postulatów	postulat	subst:pl:gen:m3
związku	związek	subst:sg:gen:m3
i	i	conj
nie	nie	qub
podjął	podjąć	praet:sg:m1:perf
negocjacji	negocjacja	subst:pl:gen:f
.	.	interp
