Dopiero	dopiero	qub
w	w	prep:acc:nwok
sobotę	sobota	subst:sg:acc:f
będzie	być	bedzie:sg:ter:imperf
wiadomo	wiadomo	pred
,	,	interp
czy	czy	qub
powstanie	powstać	fin:sg:ter:perf
rząd	rząd	subst:sg:nom:m3
koalicyjny	koalicyjny	adj:sg:nom:m3:pos
,	,	interp
czy	czy	qub
mniejszościowy	mniejszościowy	adj:sg:nom:m3:pos
.	.	interp
Zdecydują	zdecydować	fin:pl:ter:perf
o	o	prep:loc
tym	to	subst:sg:loc:n
rady	rada	subst:pl:nom:f
krajowe	krajowy	adj:pl:nom:f:pos
SLD	SLD	subst:sg:gen:m3
i	i	conj
Unii	unia	subst:sg:gen:f
Pracy	praca	subst:sg:gen:f
oraz	oraz	conj
Rada	rada	subst:sg:nom:f
Naczelna	naczelny	adj:sg:nom:f:pos
PSL	PSL	subst:sg:gen:n
.	.	interp
Aleksander	Aleksander	subst:sg:nom:m1
Kwaśniewski	Kwaśniewski	subst:sg:nom:m1
,	,	interp
będąc	być	pcon:imperf
wczoraj	wczoraj	adv
w	w	prep:loc:nwok
Belgii	Belgia	subst:sg:loc:f
,	,	interp
powiedział	powiedzieć	praet:sg:m1:perf
,	,	interp
że	że	comp
wie	wiedzieć	fin:sg:ter:imperf
,	,	interp
jaki	jaki	adj:sg:nom:m3:pos
powstanie	powstać	fin:sg:ter:perf
rząd	rząd	subst:sg:nom:m3
,	,	interp
ale	ale	conj
odmówił	odmówić	praet:sg:m1:perf
podania	podać	ger:sg:gen:n:perf:aff
konkretów	konkret	subst:pl:gen:m3
.	.	interp
