babcia	babka
bajeczka	bajka
bożek	bóg
braciszek	brat
bramka	brama
buźka	buzia
chętka	chęć
chorągiewka	chorągiew
chwileczka	chwila
chwilka	chwila
ciocia	ciotka
cioteczka	ciotka
ciotuchna	ciotka
ciotunia	ciotka
córcia	córka
córeczka	córka
córeńka	córeczka
córuchna	córka
domek	dom
dróżka	droga
druczek	druk
dworek	dwór
dziadek	dziad
dziadunio	dziadek
dziadzio	dziadziuś
dzieciątko	dziecię
dziecina	dziecko
dziecinka	dziecina
dziewczynka	dziewczyna
garstka	garść
główka	głowa
kanalik	kanał
kanałek	kanał
kapelutek	kapelusz
karteluszek	kartka
kawiarenka	kawiarnia
kieliszek	kielich
klatka	klatka
kmiotek	kmiot
kolejka	kolej
koleżka	kolega
komórka	komora
kosteczka	kostka
kostka	kość
kółko	koło
kółko	koło
kruszynka	kruszyna
książeczka	książka
kulka	kula
magazynek	magazyn
maluszek	maluch
mamusia	mama
mateczka	matka
matula	matka
miasteczko	miasto
mikrusek	mikrus
minutka	minuta
młodzieniaszek	młodzieniec
obrazek	obraz
odrobinka	odrobina
ogródek	ogród
okienko	okno
paciorek	pacierz
palik	pal
pasek	pas
pałka	pała
pioseneczka	piosenka
piosenka	pieśń
plamka	plama
poletko	pole
porcięta	portki
próbka	próba
pyszczek	pysk
płytka	płyta
ścianka	ściana
ścieżynka	ścieżyna
sekundka	sekunda
siatka	sieć
składzik	skład
stryjenka	stryjna
sumka	suma
supełek	supeł
słabostka	słabość
uliczka	ulica
walizka	waliza
węzełek	węzeł
wózek	wóz
wstążka	wstęga
wujenka	wujna
alejka	aleja
dołek	dół
domek	dom
kościółek	kościół
szafka	szafa
obłoczek	obłok
skierka	skra
płomyk	płomień
wietrzyk	wiatr
zefirek	zefir
konik	koń
kucyk	kuc
kociątko	kocię
cielaczek	cielak
schodki	schody
chmurka	chmura
deszczyk	deszcz
bródka	broda
brzuszek	brzuch
ciałko	ciało
czółko	czoło
łapka	łapa
rączka	ręka
gardziołko	gardło
szyjka	szyja
kolanko	kolano
języczek	język
kupka	kupa
gówienko	gówno
nóżka	noga
nóżka	noga
nożyna	noga
łepek	łeb
dzióbek	dziób
liczko	lico
ząbek	ząb
brzusio	brzuch
serduszko	serce
papierek	papier
powiedzonko	powiedzenie
opowiadanko	opowiadanie
pogaduszka	pogaducha
piłka	piła
kołnierzyk	kołnierz
nóżka	noga
młotek	młot
widelczyk	widelec
kółko	koło
bryłka	bryła
grudka	gruda
cząsteczka	cząstka
kawałeczek	kawałek
kawalątek	kawałek
lufka	lufa
kropelka	kropla
numerek	numer
pęczek	pęk
pętelka	pętla
miniaturka	miniatura
koszyk	kosz
odpadek	odpad
beczułka	beczka
karteczka	kartka
sznurek	sznur
kozaczek	kozak
dziurka	dziura
otworek	otwór
kosteczka	kostka
kostka	kość
kółko	koło
książka	księga
okienko	okno
opowiastka	opowieść
panienka	panna
płytka	płyta
siatka	sieć
słupek	słup
autko	auto
grzybek	grzyb
mączka	mąka
marchewka	marchew
marchewka	marchew
drzewko	drzewo
gałązka	gałąź
kwiatek	kwiat
kwiatek	kwiat
babka	baba
babka	baba
blondynek	blondyn
krasnoludek	krasnal
dziwka	dziwa
grupka	grupa
tatuś	tata
tatuś	tato
wnuczek	wnuk
chatka	chata
hotelik	hotel
kącik	kąt
kapliczka	kaplica
lasek	las
mieszkanko	mieszkanie
mostek	most
polanka	polana
skałka	skała
strumyk	strumień
wieżyczka	wieża
gwiazdka	gwiazda
gwiazdka	gwiazda
papużka	papuga
rybka	ryba
świnka	świnia
chusteczka	chustka
chustka	chusta
tasiemka	taśma
torebka	torba
płaszczyk	płaszcz
serwetka	serweta
cebulka	cebula
kamyk	kamień
gołąbek	gołąb
haczyk	hak
klocek	kloc
nożyczki	nożyce
paczuszka	paczka
poduszeczka	poduszka
woreczek	worek
łóżeczko	łóżko
kołowrotek	kołowrót
bransoletka	bransoleta
drucik	drut
pierścionek	pierścień
rurka	rura
kalendarzyk	kalendarz
tabliczka	tablica
dzbanek	dzban
figurka	figura
miseczka	miska
pokrywka	pokrywa
ramka	rama
statuetka	statua
podstawka	podstawa
czajniczek	czajnik
kratka	krata
kratka	krata
lusterko	lustro
podpórka	podpora
płotek	płot
szybka	szyba
jelonek	jeleń
koziołek	kozioł
kaczątko	kaczę
rozmówka	rozmowa
szczoteczka	szczotka
odłamek	odłam
miarka	miara
łyczek	łyk
bąbelek	bąbel
bąbelek	bąbel
koniuszek	koniec
kuleczka	kulka
mgiełka	mgła
muszka	mucha
nitka	nić
oczko	oko
pasemko	pasmo
pasemko	pasmo
puszek	puch
robaczek	robak
skorupka	skorupa
wąsik	wąs
włosek	włos
łopatka	łopata
klinik	klin
szkółka	szkoła
olejek	olej
tomik	tom
wierszyk	wiersz
rożek	róg
rożek	róg
etykietka	etykieta
etykietka	etykieta
duszyczka	dusza
duszyczka	dusza
śmieszek	śmiech
słówko	słowo
słowniczek	słownik
górka	góra
pieniążek	pieniądz
strączek	strąk
szczurek	szczur
wieczorek	wieczór
galaretka	galareta
króliczek	królik
kurka	kura
pianka	piana
pompka	pompa
nowinka	nowina
drążek	drąg
pieszczoszek	pieszczoch
klejnocik	klejnot
dziadziuś	dziadek
paletko	palto
momencik	moment
sucharek	suchar
nasadka	nasada
chichotek	chichot
jastrząbek	jastrząb
koteczka	kotka
jabłonka	jabłoń
syrenka	syrena
flecik	flet
szwagierek	szwagier
gnojek	gnój
pęcherzyk	pęcherz
iskierka	iskra
kryształek	kryształ
listek	liść
nosek	nos
pieniek	pień
piórko	pióro
promyk	promień
punkcik	punkt
punkcik	punkt
punkcik	punkt
ranka	rana
skrzydełko	skrzydło
smużka	smuga
strużka	struga
strużka	struga
strzępek	strzęp
światełko	światło
szparka	szpara
warstewka	warstwa
ziarenko	ziarno
ziarenko	ziarno
ziarnko	ziarno
altanka	altana
jeziorko	jezioro
korytarzyk	korytarz
murek	mur
pałacyk	pałac
placyk	plac
rzeczka	rzeka
salka	sala
stateczek	statek
wysepka	wyspa
zatoczka	zatoka
zatoczka	zatoka
bączek	bąk
bączek	bąk
bojka	boja
buczek	buk
chlebek	chleb
dąbek	dąb
gąsiorek	gąsior
gąsiorek	gąsior
gąska	gęś
kukiełka	kukła
lipka	lipa
piętka	pięta
świerczek	świerk
toczek	tok
wilczek	wilk
wołek	wół
aniołek	anioł
babunia	babcia
chłopczyk	chłopiec
człowieczek	człowiek
duszek	duch
gromadka	gromada
kicia	kot
ludek	lud
myszka	mysz
myszka	mysz
niedźwiadek	niedźwiedź
owieczka	owca
piesek	pies
pradziadek	pradziad
ptaszek	ptak
raczek	rak
siostrzyczka	siostra
siostrzyczka	siostra
siostrzyczka	siostra
stworzonko	stworzenie
synek	syn
twarzyczka	twarz
tłumek	tłum
wujaszek	wujek
żabka	żaba
zwierzątko	zwierzę
armatka	armata
barierka	bariera
bucik	but
buteleczka	butelka
czapeczka	czapka
drabinka	drabina
drzwiczki	drzwi
dzwonek	dzwon
dzwoneczek	dzwonek
fotelik	fotel
futerko	futro
futerko	futro
przegródka	przegroda
kartonik	karton
kartonik	karton
kieszonka	kieszeń
klapka	klapa
kociołek	kocioł
krzesełko	krzesło
kuferek	kufer
laleczka	lalka
laleczka	lalka
laseczka	laska
laseczka	laska
laseczka	laska
piłeczka	piłka
posążek	posąg
przegródka	przegroda
pudełeczko	pudełko
rzemyk	rzemień
sakiewka	sakwa
samochodzik	samochód
spódniczka	spódnica
stoliczek	stolik
szklaneczka	szklanka
sztabka	sztaba
walizeczka	walizka
bułeczka	bułka
ciasteczko	ciastko
herbatka	herbata
kiełbaska	kiełbasa
orzeszek	orzech
paluszek	palec
paluszek	paluch
formułka	formuła
liścik	list
liścik	list
miesiączek	miesiąc
nutka	nuta
nutka	nuta
przykrywka	przykrywa
gazetka	gazeta
perełka	perła
perełka	perła
teatrzyk	teatr
kwitek	kwit
scenka	scena
scenka	scena
bębenek	bęben
krzewinka	krzewina
chlebuś	chleb
szlemik	szlem
obrządek	obrzęd
kabłączek	kabłąk
byczek	byk
diabełek	diabeł
diablik	diabeł
ogóreczek	ogórek
pięterko	piętro
bagienko	bagno
bagienko	bagno
bajorko	bajoro
dolinka	dolina
kotlinka	kotlina
gąska	gęś
kłamczuszek	kłamczuch
kątek	kąt
kątek	kąt
anegdotka	anegdota
broszurka	broszura
broszurka	broszura
bilecik	bilet
bilecik	bilet
zbłąkana owieczka	zbłąkana owca
filmik	film
batonik	baton
głuptas	głupek
kotlecik	kotlet
ozorek	ozór
ozorek	ozór
placuszek	placek
placuszek	placek
młotek	młot
diabełek	diabeł
ancymonek	ancymon
mapka	mapa
melodyjka	melodia
muzyczka	muzyka
muzyczka	muzyka
muzyczka	muzyka
nowelka	nowela
oczko	oko
pisemko	pismo
rozprawka	rozprawa
leniuszek	leniuch
pijaczek	pijak
maglarka	maglara
panek	pan
żłobek	żłób
żłóbek	żłób
typek	typ
złodziejaszek	złodziej
łotrzyk	łotr
prosiątko	prosię
wieprzak	wieprz
soczek	sok
torcik	tort
twarożek	twaróg
ziemniaczek	ziemniak
zupka	zupa
ramka	rama
cyganek	cygan
cyganeczka	cyganka
czarnulka	czarnula
czarnuszka	czarnucha
czarnuszka	czarnula
Murzynek	Murzyn
loszka	locha
maciorka	maciora
pudelek	pudel
pedzio	pedał
ratlerek	ratler
brzeżek	brzeg
maseczka	maska
maseczka	maska
psiaczek	psiak
psinka	psina
psiunia	psina
maseczka	maska
boginka	bogini
fajeczka	fajka
ciuszek	ciuch
szmatka	szmata
czółenko	czółno
karzełek	karzeł
krasnalek	krasnal
olszynka	olszyna
rabatka	rabata
budyneczek	budynek
knajpka	knajpa
kraik	kraj
kramik	kram
pelerynka	peleryna
firaneczka	firanka
kocyk	koc
pledzik	pled
kołderka	kołdra
krawacik	krawat
krawacik	krawat
kubraczek	kubrak
mufka	mufa
onucka	onuca
panterka	pantera
pończoszka	pończocha
poszewka	poszwa
powłoczka	powłoka
sandałek	sandał
serdaczek	serdak
sukieneczka	sukienka
szatka	szata
ubranko	ubranie
skórka	skóra
rynienka	rynna
rzeczułka	rzeczka
kapitalik	kapitał
drożyna	droga
spłachetek	spłacheć
karnecik	karnet
straganik	stragan
twarożek	twaróg
zbiorek	zbiór
źródełko	źródło
chrypka	chrypa
winko	wino
królówka	królowa
konik	koń
kamieniczka	kamienica
piwniczka	piwnica
drożynka	drożyna
restauracyjka	restauracja
skwerek	skwer
spelunka	speluna
szpitalik	szpital
wioseczka	wioska
uszko	ucho
łódeczka	łódka
łupinka	łupina
urzynek	urzyn
bryczuszka	bryczka
czareczka	czarka
flakonik	flakon
wazonik	wazon
silniczek	silnik
przyczepka	przyczepa
rakietka	rakieta
stosik	stos
górka	góra
kopczyk	kopiec
kupeczka	kupka
kupka	kupa
kopczyk	kopiec
tłuczek	tłuk
chórek	chór
niteczka	nitka
fujareczka	fujarka
piszczałeczka	piszczałka
gęśliki	gęśle
cipka	cipa
kuciapka	kuciapa
piczka	picza
cymbałki	cymbały
inteligencik	inteligent
wojenka	wojna
doktorek	doktor
ozdóbka	ozdoba
babcia	baba
babinka	babina
babuleńka	babulka
babulka	babula
starowinka	starowina
jabłuszko	jabłko
kluseczka	kluska
pierniczek	piernik
brudasek	brudas
flejtuszek	flejtuch
kocmołuszek	kocmołuch
kopciuszek	kopciuch
babeczka	babka
babeczka	babka
babka	baba
karczek	kark
kaszka	kasza
mięsko	mięso
wódeczka	wódka
zrazik	zraz
loczek	lok
kędziorek	kędzior
fioczek	fiok
pukielek	pukiel
ryjek	ryj
ryjek	ryj
warkoczyk	warkocz
aktoreczka	aktorka
rodzinka	rodzina
sierotka	sierota
flaczek	flak
szypułka	szypuła
obrąbek	obręb
obrębek	obręb
baczki	baki
baczek	bak
elegancik	elegant
tarczka	tarcza
paniusia	pani
damulka	damula
książątko	książę
kurewka	kurwa
wdówka	wdowa
cyraneczka	cyranka
głowienka	głownia
pakiecik	pakiet
tabelka	tabela
skrzynka	skrzynia
mierzynek	mierzyn
pławka	pława
bródka	broda
balkonik	balkon
basenik	basen
basenik	basen
koszyczek	koszyk
patyczek	patyk
roślinka	roślina
łodyżka	łodyga
węgielek	węgiel
krzewina	krzew
stroik	strój
latarenka	latarnia
jajeczko	jajko
jajeczko	jajko
ogarek	ogar
bliźniaczek	bliźniak
Pepiczek	Pepik
Niemiaszek	Niemiec
bagatelka	bagatela
posadka	posada
świerszczyk	świerszcz
Polaczek	Polak
garnczek	garnek
kordzik	kord
szabelka	szabla
szczebelek	szczebel
sztylecik	sztylet
wahadełko	wahadło
bufka	bufa
lilijka	lilia
ceberek	ceber
strofka	strofa
trepek	trep
trepek	trep
żytko	żyto
żytko	żyto
harcerzyk	harcerz
flirciarka	flirciara
cukiereczek	cukierek
pchełka	pchła
oddziałek	oddział
błonka	błona
igiełka	igła
igiełka	igła
igiełka	igła
igiełka	igła
samczyk	samiec
pupka	pupa
ramionko	ramię
słonko	Słońce
słoneczko	słonko
słonko	słońce
słoneczko	słonko
słonko	słońce
tyłeczek	tyłek
usteczka	usta
drobinka	drobina
drobinka	drobina
beleczka	belka
beleczka	belka
całusek	całus
koteczek	kotek
kotek	kot
koteczek	kotek
koteczka	kotka
chałturka	chałtura
stówka	stówa
zdanko	zdanie
denko	dno
kopułka	kopuła
kotwiczka	kotwica
kotwiczka	kotwica
piramidka	piramida
pochewka	pochwa
sprężynka	sprężyna
tulejka	tuleja
tulejka	tuleja
wiatraczek	wiatrak
wentylatorek	wentylator
zbiorniczek	zbiornik
żerdka	żerdź
aparacik	aparat
ekranik	ekran
kabinka	kabina
namiocik	namiot
notesik	notes
okręcik	okręt
pistolecik	pistolet
portrecik	portret
samolocik	samolot
saneczki	sanki
telewizorek	telewizor
trumienka	trumna
tłumoczek	tłumok
żaróweczka	żarówka
łańcuszek	łańcuch
guziczek	guzik
kabelek	kabel
kanalik	kanał
korbka	korba
kołeczek	kołek
kołeczek	kołek
kołeczek	kołek
kranik	kran
wanienka	wanna
lewarek	lewar
lewarek	lewar
miotełka	miotła
banieczka	bańka
banieczka	bańka
kitka	kita
kreseczka	kreska
paseczek	pasek
pasek	pas
paseczek	pasek
siateczka	siatka
siateczka	siatka
siatka	sieć
szczecinka	szczecina
szlaczek	szlak
tekturka	tektura
wałeczek	wałek
wianuszek	wianek
wianuszek	wianek
wianuszek	wianek
żagielek	żagiel
łatka	łata
łatka	łata
makatka	makata
artykulik	artykuł
blondasek	blondas
blondyneczka	blondynka
buziaczek	buziak
cherubinek	cherubin
chłopaczek	chłopak
plecaczek	plecak
dołeczek	dołek
dołeczek	dołek
dziewczątko	dziewczę
dzieweczka	dziewka
dziewuszka	dziewucha
facecik	facet
istotka	istota
jagniątko	jagnię
kobietka	kobieta
kobitka	kobita
kolacyjka	kolacja
kolorek	kolor
kurczątko	kurczę
kłamstewko	kłamstwo
lalunia	lala
ojczulek	ojciec
ojczulek	ojciec
panieneczka	panienka
prababcia	prababka
prezencik	prezent
ptaszyna	ptak
pytanko	pytanie
stryjek	stryj
stryjko	stryjo
syneczek	synek
szczególik	szczegół
wujko	wujo
zabaweczka	zabawka
żoneczka	żonka
żonka	żona
ołtarzyk	ołtarz
łasiczka	łasica
dziełko	dzieło
grzeszek	grzech
muterka	mutra
hasełko	hasło
hasełko	hasło
hasełko	hasło
jagódka	jagoda
jagódka	jagoda
metryczka	metryka
metryczka	metryka
arkusik	arkusz
rulonik	rulon
guzek	guz
guzek	guz
krezka	kreza
tętniczka	tętnica
cząstka	część
stroniczka	strona
klimacik	klimat
chlewik	chlew
kaczuszka	kaczka
domeczek	domek
fabryczka	fabryka
kogutek	kogut
kogucik	kogut
kumoszka	kuma
kurczaczek	kurczak
lewek	lew
lwiątko	lwię
jesionek	jesion
nasionko	nasiono
samiczka	samica
druczek	druk
brzezinka	brzezina
brzezinka	brzoza
sionka	sień
drwinka	drwina
stryszek	strych
polanko	polano
bluzeczka	bluzka
czepeczek	czepek
fartuszek	fartuch
kaftanik	kaftan
kapelusik	kapelusz
kurteczka	kurtka
majteczki	majtki
wróbelek	wróbel
zajączek	zając
żołnierzyk	żołnierz
cyferka	cyfra
kropeczka	kropka
kropeczka	kropka
kropeczka	kropka
kropeczka	kropka
cyferka	cyfra
kwadracik	kwadrat
kwiatuszek	kwiatek
literka	litera
ogienek	ogień
promyczek	promyk
prostokącik	prostokąt
płomyczek	płomyk
torebeczka	torebka
trójkącik	trójkąt
ociupinka	ociupina
kokardka	kokarda
pieluszka	pielucha
śpiworek	śpiwór
ściereczka	ścierka
wstążeczka	wstążka
muszelka	muszla
kamyczek	kamyk
brytfanka	brytfanna
cążki	cęgi
deseczka	deska
mundurek	mundur
mantylka	mantyla
mantylka	mantyla
slipki	slipy
staniczek	stanik
staniczek	stanik
sweterek	sweter
szlafroczek	szlafrok
żakiecik	żakiet
listewka	listwa
nożyk	nóż
pędzelek	pędzel
trójeczka	trójka
śrubka	śruba
szczypczyki	szczypce
szczypczyki	szczypce
zasuwka	zasuwa
smaczek	smak
ramotka	ramota
kolumienka	kolumna
antałek	antał
dzbanuszek	dzbanek
kieliszeczek	kieliszek
kieliszeczek	kieliszek
wiaderko	wiadro
kubełek	kubeł
naczynko	naczynie
naczynko	naczynie
pucharek	puchar
pucharek	puchar
puzderko	puzdro
rondelek	rondel
spodeczek	spodek
słoiczek	słoik
tacka	taca
miedniczka	miednica
pieprzyk	pieprz
skarbczyk	skarbiec
farbka	farba
flaszeczka	flaszka
garnuszek	garnek
chruścik	chrust
kliczka	klika
obiadek	obiad
partyjka	partia
partyjka	partia
mydełko	mydło
mydełko	mydło
bydlątko	bydlę
gębusia	gęba
gębusia	gęba
śniadanko	śniadanie
spacerek	spacer
buraczek	burak
fasolka	fasola
fasolka	fasola
buraczek	burak
bydełko	bydło
kasztanek	kasztan
klaczka	klacz
małpka	małpa
przylepka	przylepa
kiciunia	kicia
kiciuś	kicia
kocurek	kocur
osiołek	osioł
brylancik	brylant
bukiecik	bukiet
chrapka	chrapa
imadełko	imadło
fałdka	fałda
gwiazdeczka	gwiazda
gwiazdeczka	gwiazdka
gwiazdeczka	gwiazdka
kłębuszek	kłębek
chmurka	chmura
obłoczek	obłok
kłębuszek	kłąb
okularki	okulary
różyczka	róża
różyczka	róża
zeszycik	zeszyt
breloczek	brelok
cudeńko	cudo
szalka	szala
tabakierka	tabakiera
trybik	tryb
bateryjka	bateria
lunetka	luneta
prosiaczek	prosiak
prosiaczek	prosiak
sarenka	sarna
suczka	suka
wieprzek	wieprz
modraczek	modrak
dreszczyk	dreszcz
truchcik	trucht
biesiadka	biesiada
stajenka	stajnia
motorek	motor
kieska	kiesa
ogierek	ogier
wiaterek	wiatr
wicherek	wicher
baraczek	barak
cerkiewka	cerkiew
brzózka	brzoza
baźka	bazia
sosenka	sosna
mieczyk	miecz
Bozia	Bóg
chłodek	chłód
ciepełko	ciepło
ciepełko	ciepło
dziadzia	dziadziuś
gołąbeczka	gołąbka
głuptasek	głuptas
mateńka	mateczka
znajomek	znajomy
nocka	noc
wisienka	wiśnia
wisienka	wiśnia
biureczko	biurko
gablotka	gablota
komódka	komoda
mebelek	mebel
półeczka	półka
stołeczek	stołek
szufladka	szuflada
bryczka	bryka
powozik	powóz
rowerek	rower
wózeczek	wózek
abażurek	abażur
rycerzyk	rycerz
rycerzyk	rycerz
słóweczko	słówko
gzymsik	gzyms
gzymsik	gzyms
gzymsik	gzyms
koniaczek	koniak
koźlątko	koźlę
koźlątko	koźlę
pipka	pipa
cytrynka	cytryna
cytrynka	cytryna
turniczka	turnia
szpileczka	szpilka
szpileczka	szpilka
szpileczka	szpilka
akwarelka	akwarela
albumik	album
albumik	album
albumik	album
albumik	album
albumik	album
chodniczek	chodnik
chodniczek	chodnik
chodniczek	chodnik
chodniczek	chodnik
cypelek	cypel
cypelek	cypel
filiżaneczka	filiżanka
filiżaneczka	filiżanka
forteczka	forteca
forteczka	forteca
fragmencik	fragment
gabinecik	gabinet
gabinecik	gabinet
ganeczek	ganek
handelek	handel
humorek	humor
interesik	interes
interesik	interes
interesik	interes
jodełka	jodła
komplecik	komplet
księstewko	księstwo
ksiąstewko	księstwo
obróżka	obroża
obróżka	obroża
obróżka	obroża
pakuneczek	pakunek
pawilonik	pawilon
pawilonik	pawilon
pomniczek	pomnik
pomniczek	pomnik
pomponik	pompon
radyjko	radio
ręczniczek	ręcznik
szczelinka	szczelina
telefonik	telefon
warsztacik	warsztat
warsztacik	warsztat
winietka	winieta
zydelek	zydel
harmoszka	harmonia
ćwieczek	ćwiek
głodek	głód
jagiełka	jagła
jagiełka	jagła
sęczek	sęk
diamencik	diament
głąbik	głąb
głąbek	głąb
kuperek	kuper
kuperek	kuper
kłosek	kłos
dyrektorek	dyrektor
bestyjka	bestia
mężuś	mąż
siostrunia	siostra
tatko	tato
tatka	tata
pancerzyk	pancerz
pancerzyk	pancerz
raciczka	racica
becik	bet
blaszka	blacha
deszczułka	deska
dranka	dranica
drewienko	drewno
frędzelek	frędzel
frędzelka	frędzla
tafelka	tafla
obrzynek	obrzyn
pliska	plisa
mieszadełko	mieszadło
szczapka	szczapa
watka	wata
zasłonka	zasłona
biedulka	biedula
drobiażdżek	drobiazg
głowina	głowa
przystojniaczek	przystojniak
tekścik	tekst
tysiączek	tysiąc
tłuścioszek	tłuścioch
grubasek	grubas
zwierzaczek	zwierzak
państewko	państwo
recenzyjka	recenzja
cyprysik	cyprys
przełączka	przełęcz
wariatuńcio	wariat
lokomotywka	lokomotywa
kokoryczka	kokorycz
kotewka	kotew
kotewka	kotew
kotewka	kotew
zieleninka	zielenina
jałóweczka	jałówka
kózka	koza
kózka	koza
załomek	załom
ździebełko	źdźbło
ździebełeczko	ździebełko
ździebełko	ździebko
ździebełeczko	ździebełko
bibka	biba
imprezka	impreza
jedzonko	jedzenie
klasztorek	klasztor
szelążek	szeląg
szczawik	szczaw
kpinka	kpina
kuzynek	kuzyn
pociotek	pociot
półuśmieszek	półuśmiech
charakterek	charakter
poleczka	polka
sztachetka	sztacheta
cukierniczka	cukiernica
imbryczek	imbryk
kolbka	kolba
ciągotki	ciągoty
ciągotki	ciągoty
ciągotki	ciągoty
chucherko	chuchro
kufelek	kufel
skrzyneczka	skrzynka
skrzyneczka	skrzynka
skrzyneczka	skrzynka
lokalik	lokal
sofka	sofa
szafeczka	szafka
tapczanik	tapczan
okruszynka	okruch
rękawek	rękaw
skibka	skiba
makaronik	makaron
płucko	płuco
racuszek	racuch
słoninka	słonina
kluseczki	kluski
gwoździk	gwóźdź
ćwieczek	ćwiek
zaworek	zawór
jarczyk	jar
żuczek	żuk
ciemiączko	ciemię
żurawik	żuraw
gruczołek	gruczoł
stempelek	stempel
stempelek	stempel
dłutko	dłuto
grocik	grot
obuszek	obuch
pilniczek	pilnik
szpachelka	szpachla
bałwanek	bałwan
kostiumik	kostium
piżamka	piżama
łapcia	łapa
krostka	krosta
laseczek	lasek
grajdołek	grajdoł
gronko	grono
gronko	grono
prapradziadek	prapradziad
przyjaciółeczka	przyjaciółka
konsolka	konsola
konsolka	konsola
błotko	błoto
kłaczek	kłaki
solarka	solara
ogniwko	ogniwo
monetka	moneta
trynio	tryper
gałeczka	gałka
gałeczka	gałka
balustradka	balustrada
dźwigienka	dźwignia
podkówka	podkowa
czuprynka	czupryna
piąstka	pięść
rączyna	ręka
stópka	stopa
brunecik	brunet
cielątko	cielę
kuzyneczka	kuzynka
przepióreczka	przepiórka
utworek	utwór
stodółka	stodoła
awanturka	awantura
medalionik	medalion
szafirek	szafir
szafirek	szafir
teoryjka	teoria
balasek	balas
berecik	beret
małpeczka	małpka
małpeczka	małpka
pszczółka	pszczoła
fasetka	faseta
fasetka	faseta
maleńkość	małość
baryłeczka	baryłka
baryłka	baryła
baryłeczka	baryłka
kleszczyki	kleszcze
kleszczyki	kleszcze
klubik	klub
klubik	klub
knotek	knot
kochaneczka	kochanka
kochaneczek	kochanek
kołpaczek	kołpak
komedyjka	komedia
koreczek	korek
pierzynka	pierzyna
jaskółeczka	jaskółka
jedlinka	jedlina
jedlinka	jedlina
jolka	jola
głosik	głos
bigosik	bigos
bukłaczek	bukłak
drabka	drabina
kadłubek	kadłub
folwarczek	folwark
karczemka	karczma
dziateczki	dziatki
karliczka	karlica
dzieciaczek	dzieciak
francuzik	Francuz
cerka	cera
chichotek	chichot
chochelka	chochla
guńka	gunia
rysuneczek	rysunek
chytrusek	chytrus
gawędka	gawęda
tuszka	tusza
łuseczka	łuska
łuseczka	łuska
dębczak	dąb
regułka	reguła
regułka	reguła
kutasik	kutas
kutasek	kutas
listeczek	listek
mająteczek	majątek
mająteczek	majątek
pensyjka	pensja
pensyjka	pensja
porcyjka	porcja
porcyjka	porcja
skrzatek	skrzat
świątyńka	świątynia
szkielecik	szkielet
słonik	słoń
oficerek	oficer
paniczyk	panicz
karmazynek	karmazyn
kwoczka	kwoka
ptaszynka	ptaszyna
ptaszynka	ptaszyna
ślinka	ślina
żmijka	żmija
kawka	kawa
kawunia	kawa
kawusia	kawa
mieszek	miech
łebek	łeb
sroczka	sroka
gołąbeczek	gołąbek
trupek	trup
ugorek	ugór
wachlarzyk	wachlarz
wachlarzyk	wachlarz
łapina	łapa
łapina	łapa
łysinka	łysina
żółwik	żółw
tłuszczyk	tłuszcz
tłuszczyk	tłuszcz
prostaczek	prostak
papierosek	papieros
wałek	wał
fiutek	fiut
rządek	rząd
sianko	siano
panewka	panew
piosneczka	piosnka
precelek	precel
marynareczka	marynarka
majonezik	majonez
kursik	kurs
trybulka	trybula
maszynka	maszyna
mężulek	mężulo
publiczka	publika
karafeczka	karafka
chmureczka	chmurka
włosięta	włosy
dryndulka	drynda
sielawka	sielawa
ścieżeczka	ścieżka
paltko	palto
globusik	globus
kompocik	kompot
kuplecik	kuplet
elementarzyk	elementarz
krynolinka	krynolina
krynolinka	krynolina
krynolinka	krynolina
wodospadzik	wodospad
lewatywka	lewatywa
zygzaczek	zygzak
bitewka	bitwa
kłusik	kłus
paszporcik	paszport
makietka	makieta
koteryjka	koteria
półpięterko	półpiętro
konkursik	konkurs
dukacik	dukat
krówka	krowa
nadzionko	nadzienie
nadzionko	nadzienie
kołyseczka	kołyska
trefelek	trefl
ziółka	zioła
cedułka	ceduła
cedułka	ceduła
granacik	granat
setuchna	setka
spiżarenka	spiżarka
baźka	bazia
chałacik	chałat
etacik	etat
porcik	port
bałaganik	bałagan
spineczka	spinka
kontrakcik	kontrakt
kontrakcik	kontrakt
kontrakcik	kontrakt
zakręcik	zakręt
kaczusia	kaczuszka
stertka	sterta
festiwalik	festiwal
gadułka	gaduła
bocianiątko	bocianię
peniuarek	peniuar
peniuarek	peniuar
człowieczek	człowiek
kropidełko	kropidło
kropidełko	kropidło
golasek	golas
bełkocik	bełkot
bełkocik	bełkot
bełkocik	bełkot
matołek	matoł
pradziadek	pradziad
kompotierka	kompotiera
piaseczek	piasek
lisiurka	lisiura
lisiurka	lisiura
symultanka	symultana
ćwiartuchna	ćwiartka
nieboraczek	nieborak
kaftaniczek	kaftanik
piekarenka	piekarnia
zwierciadełko	zwierciadło
truchcik	trucht
lisiątko	lisię
gąsieniczka	gąsienica
garnuszeczek	garnuszek
kabriolecik	kabriolet
kabriolecik	kabriolet
noseczek	nosek
desenik	deseń
morduchna	morda
morduchna	morda
loncik	lont
wykładzik	wykład
moteczek	motek
rzepka	rzepa
klapeczka	klapka
klapka	klapa
klapeczka	klapka
irysek	irys
tygrysiątko	tygrysię
fląderka	flądra
kompresik	kompres
kojczyk	kojec
kartka pocztowa	karta pocztowa
siekaninka	siekanina
dzierżawka	dzierżawa
szatanek	szatan
kornecik	kornet
kornecik	kornet
koneweczka	konewka
koneweczka	konewka
konewka	konew
koneweczka	konewka
konewka	konew
koneweczka	konewka
chłopyś	chłopiec
leguminka	legumina
krosteczka	krostka
botwinka	botwina
natka	nać
listek laurowy	liść laurowy
listek bobkowy	liść bobkowy
orlątko	orlę
spiralka	spirala
podwóreczko	podwórko
chałupka	chałupa
chałupka	chałupa
pierścioneczek	pierścionek
portaski	portasy
podanko	podanie
krakowiaczek	krakowiak
krakowiaczek	krakowiak
krakowiaczek	krakowiak
skrzypki	skrzypce
skrzypeczki	skrzypki
niuansik	niuans
sówka	sowa
sóweczka	sówka
zdrówko	zdrowie
zdrówko	zdrowie
masełko	masło
wysepka	wyspa
kawałeczek	kawałek
kawalątek	kawałek
kawalątko	kawałek
płachetek	płacheć
pniaczek	pniak
pniaczek	pniak
konwalijka	konwalia
uzdeczka	uzda
sztajerek	sztajer
pęcherzyk	pęcherz
banieczka	bańka
kamuszek	kamyk
sierpik	sierp
kropelka	kropla
kożuszek	kożuch
łuczek	łuk
łuczek	łuk
dietka	dieta
pulpecik	pulpet
chudziaczek	chudziak
szczupaczek	szczupak
szczurek	szczur
kostka	kość
masełko	masło
cwaniaczek	cwaniak
łobuziak	łobuz
kapuśniaczek	kapuśniak
porządeczek	porządek
rzemyczek	rzemyk
rosołek	rosół
ziółko	zioło
cylinderek	cylinder
cylinderek	cylinder
cylinderek	cylinder
mówka	mowa
rubryczka	rubryka
literek	litr
mogiłka	mogiła
palemka	palma
palemka	palma
rólka	rola
ryneczek	rynek
tarasik	taras
pupilek	pupil
pupilek	pupil
kundelek	kundel
prząśniczka	prząśnica
arcydziełko	arcydzieło
jabłoneczka	jabłonka
baranek	baran
incydencik	incydent
babcia klozetowa	babka klozetowa
plecki	plecy
jeżyk	jeż
prożek	próg
szczygiełek	szczygieł
wieśniaczek	wieśniak
kamyk	kamień
kamyczek	kamyk
perełki	perły
pajdka	pajda
kromeczka	kromka
łączka	łąka
żwirek	żwir
obrazeczek	obrazek
lemoniadka	lemoniada
koczyk	kocz
kuchareczka	kucharka
żabocik	żabot
księgarenka	księgarnia
szewek	szew
dobry wujaszek	dobry wujek
kozaczek	kozak
koźlaczek	koźlak
krysztalik	kryształ
krzesiwko	krzesiwo
kaszkiecik	kaszkiet
rubryczka	rubryka
kolorki	kolory
córuś	córka
filutek	filut
kapustka	kapusta
śpioszek	śpioch
pałka	pała
żarówka	żarówa
wędrowniczek	wędrownik
bańka	bania
staruszek	stary
papcio	papa
łepetynka	łepetyna
kupczyk	kupiec
minetka	mineta
kółko	koło
kanalik	kanał
korytarzyk	korytarz
partyjka	partia
sznurek	sznur
sznureczek	sznurek
pajęczynka	pajęczyna
słupek	słup
kółko	koło
kółko	koło
kółeczko	kółko
kółeczko	kółko
kółeczko	kółko
kółeczko	kółko
kółeczko	kółko
placyk	plac
pejzażyk	pejzaż
pejzażyk	pejzaż
ostrówek	ostrów
szefunio	szef
szefuńcio	szef
studzienka	studnia
chłopek	chłop
ambicyjka	ambicja
ambicyjka	ambicja
krzyżyk	krzyż
praska	prasa
dziadek	dziad
dziadek	dziad
blogasek	blog
kożuch	baran
nektarynka	nektaryna
nózia	noga
tratewka	tratwa
limonka	limona
transik	trans
bożek	bóg
bożek	bóg
braciszek	brat
bratek	brat
foczka	foka
krosienko	krosno
księżyk	ksiądz
alkierzyk	alkierz
alkierzyk	alkierz
grzbiecik	grzbiet
lóżka	loża
neseserek	neseser
reflektorek	reflektor
cegiełka	cegła
szacuneczek	szacunek
kajaczek	kajak
chałupniczka	chałupnica
chałupniczka	chałupnica
sutanka	sutanna
komeżka	komża
trzosik	trzos
cherubinek	cherubin
chłopyszek	chłopyś
rybeńka	rybka
iskierka	iskra
ikonka	ikona
małolatek	małolat
małolatka	małolata
pelerynka	peleryna
tenorek	tenor
zmianka	zmiana
akumulatorek	akumulator
modelik	model
cipka	cipa
cipcia	cipa
pipcia	pipa
cipeczka	cipka
cipeczka	cipa
chujek	chuj
fiutek	fiut
córeczka	córka
kobyłka	kobyła
stworek	stwór
Cyganek	Cygan
Cyganeczka	Cyganka
szaliczek	szalik
portfelik	portfel
szpareczka	szparka
szparka	szpara
cipcia	cipka
cipuszka	cipka
cipuszka	cipcia
iskiereczka	iskierka
iskiereczka	iskierka
jamniczek	jamnik
owocek	owoc
łuszczynka	łuszczyna
urwisek	urwis
mopsik	mops
nimfetka	nimfomanka
lolitka	lolita
futeralik	futerał
czyścioszek	czyścioch
kaczorek	kaczor
biszkopcik	biszkopt
fundusik	fundusz
niebożątko	niebożę
knypek	knyp
pieszczotka	pieszczota
łezka	łza
libacyjka	libacja
rózeczka	rózga
tareczka	tarka
techniawka	techniawa
koncepcyjka	koncepcja
kalafiorek	kalafior
kometka	kometa
koronka	korona
lalusia	lalunia
lalusia	lalka
koralik	koral
śledzik	śledź
śledzik	śledź
śledzik	śledź
lowelasek	lowelas
knurek	knur
kabarecik	kabaret
guścik	gust
kanapeczka	kanapka
lustereczko	lusterko
mróweczka	mrówka
mróweczka	mrówka
kłódeczka	kłódka
lichtarzyk	lichtarz
oficynka	oficyna
paznokietek	paznokieć
pomidorek	pomidor
tygielek	tygiel
tygielek	tygiel
chomątko	chomąto
półgroszek	półgrosz
serniczek	sernik
kalarepka	kalarepa
papryczka	papryka
plasterek	plaster
kancik	kant
kancik	kant
rancik	rant
górka	góra
górka	góra
dołek	dół
dołek	dół
dołek	dół
dziedzińczyk	dziedziniec
komnatka	komnata
świątynka	świątynia
piłkarzyk	piłkarz
emeryturka	emerytura
emeryturka	emerytura
sadełko	sadło
dowcipasek	dowcipas
dowcipasek	dowcipas
kamaszek	kamasz
atmosferka	atmosfera
bruzdka	bruzda
bruzdka	bruzda
stylik	stylisko
duszyczka	dusza
dupka	dupa
dupcia	dupa
osóbka	osoba
karczmareczka	karczmarka
prawnuczek	prawnuk
zadziorek	zadzior
królewiątko	królewicz
cycuszek	cycek
dziewczyneczka	dziewczynka
fryzurka	fryzura
szczeniaczek	szczeniak
źrebaczek	źrebak
trzoneczek	trzonek
trzoneczek	trzonek
flanelka	flanela
paraszka	parasza
babusia	babunia
garniturek	garnitur
haleczka	halka
półbucik	półbut
trawka	trawa
polityczka	polityka
autobusik	autobus
jamka	jama
jamka	jama
drablinka	drablina
poidełko	poidło
komputerek	komputer
środeczek	środek
wódzia	wódka
narodek	naród
studencik	student
szyneczka	szynka
kuchcik	kuchta
stworzątko	stworzenie
korytko	koryto
korytko	koryto
garbusek	garbus
wiosenka	wiosna
wiosenka	wiosna
fakcik	fakt
krateczka	kratka
krateczka	kratka
krateczka	kratka
krateczka	kratka
złośliwostka	złośliwość
ośliczka	oślica
kukułeczka	kukułka
ubiorek	ubiór
brewka	brew
bulwka	bulwa
koksik	koks
obcasik	obcas
dziecinka	dziecina
szumek	szum
szumek	szum
cukierenka	cukiernia
cukierenka	cukiernia
działeczka	działka
wyprawka	wyprawa
wyprawka	wyprawa
działeczka	działka
gąbeczka	gąbka
gąbeczka	gąbka
jachcik	jacht
klateczka	klatka
klateczka	klatka
klateczka	klatka
latareczka	latarka
materacyk	materac
problemik	problem
problemik	problem
przedmiocik	przedmiot
rureczka	rurka
rondko	rondo
rondko	rondo
sekrecik	sekret
damulka	damula
ślimaczek	ślimak
ślimaczek	ślimak
lalka	lala
laleczka	lalka
blondzia	blondynka
zapasik	zapas
drobiażdżek	drobiazg
szczególik	szczegół
bawidełko	bawidło
głupstewko	głupstwo
duperelka	duperela
duperelki	duperele
duperelka	duperela
duperelki	duperele
gówienko	gówno
bajeczka	bajka
cacuszko	cacko
poemacik	poemat
arkadka	arkada
diablątko	diablę
diablątko	diablę
kangurek	kangur
kilimek	kilim
kopertka	koperta
kwadransik	kwadrans
lawinka	lawina
plusik	plus
minusik	minus
seansik	seans
szańczyk	szaniec
taborecik	taboret
scenka	scena
scenka	scena
ocenka	ocena
felietonik	felieton
furteczka	furtka
furteczka	furtka
programik	program
przyjemnostka	przyjemność
romansik	romans
rundka	runda
rundka	runda
sensacyjka	sensacja
skandalik	skandal
smuteczek	smutek
spółeczka	spółka
świństewko	świństwo
świństewko	świństwo
zakładzik	zakład
zakładzik	zakład
zakładzik	zakład
teatrzyk	teatr
epizodzik	epizod
epizodzik	epizod
epizodzik	epizod
turbinka	turbina
wnusia	wnuczka
odnóżka	odnoga
odnóżka	odnoga
układzik	układ
kopystka	kopyść
skopek	skop
oponka	opona
sopelek	sopel
sopelek	rzodkiew sopel lodu
brzydulka	brzydula
luteńka	lutnia
pamiętniczek	pamiętnik
pęsetka	pęseta
pincetka	pinceta
przyrządzik	przyrząd
śliweczka	śliwka
szczeniątko	szczenię
grzebyk	grzebień
grzebyczek	grzebyk
pojemniczek	pojemnik
puszeczka	puszka
sześcianik	sześcian
sztyfcik	sztyft
sztyfcik	sztyft
inżynierek	inżynier
cokolik	cokół
gilotynka	gilotyna
krokodylek	krokodyl
szpadka	szpada
imionko	imię
ostewka	ostew
grzaneczka	grzanka
kociaczek	kociak
pączek	pąk
truskaweczka	truskawka
nocniczek	nocnik
żardynierka	żardyniera
garstka	garść
garstka	garść
garstka	garść
garsteczka	garstka
garsteczka	garstka
garsteczka	garstka
koszyczek	koszyk
serduszko	serce
serduszko	serce
serduszko	serce
serduszko	serce
kącik	kąt
kącik	kąt
nutka	nuta
pisemko	pismo
numerek	numer
numerek	numer
numerek	numer
płomyczek	płomyk
płomyczek	płomyk
iskierka	iskra
figurka	figura
znaczek	znak
strzałka	strzała
jolka	jola
pączuszek	pączek
pączuszek	pączek
maszynka	maszyna
miniaturka	miniatura
wujek	wuj
tysiaczek	tysiak
tysiączek	tysiąc
tysiak	tysiąc
dzwonniczka	dzwonnica
koniczynka	koniczyna
junaczka	junak
junaczka	junak
junaczek	junak
junaczek	junak
baletniczka	baletnica
kołchoźniczka	kołchoźnica
śpioszki	śpiochy
stolniczka	stolnica
wstręciuszka	wstręciucha
piwniczka	piwnica
piwniczka	piwnica
dzielniczka	dzielnica
dzielniczka	dzielnica
parowniczka	parownica
świetliczka	świetlica
świetliczka	świetlica
kaska	kasa
kasiorka	kasiora
karierka	kariera
balladka	ballada
balladka	ballada
balladka	ballada
baroniątko	baron
bocianek	bocian
estradka	estrada
gawroniątko	gawronię
gąsiątko	gąsię
rozsadka	rozsada
skeczyk	skecz
turbanek	turban
biczyk	bicz
bizoniątko	bizonię
kurhanek	kurhan
tulipanek	tulipan
marmoladka	marmolada
łachmanek	łachman
łachmanek	łachman
tyranek	tyran
aniołeczek	aniołek
aniołeczek	aniołek
blacik	blat
chodaczek	chodak
dowcipek	dowcip
dowcipek	dowcip
drużynka	drużyna
drużynka	drużyna
drużynka	drużyna
dzieżka	dzieża
gródek	gród
gródek	gród
klombik	klomb
kremik	krem
kremik	krem
nereczka	nerka
nereczka	nerka
parasolik	parasol
pensjonacik	pensjonat
peruczka	peruka
ropuszka	ropucha
ropuszka	ropucha
sardelka	sardela
śnieżek	śnieg
śnieżek	śnieg
strunka	struna
strunka	struna
surducik	surdut
szlachcianeczka	szlachcianka
szynkareczka	szynkarka
szynkareczka	szynkarka
szynkareczka	szynkarka
tamponik	tampon
zrostek	zrost
zrostek	zrost
zrostek	zrost
zrostek	zrost
żupanik	żupan
aluzyjka	aluzja
biedaczek	biedak
biedaczek	biedak
charciczka	charcica
fabułka	fabuła
gałązeczka	gałązka
gorzałeczka	gorzałka
kijek	kij
kijek	kij
kiełbik	kiełb
kobiecinka	kobiecina
kopytko	kopyto
kopytko	kopyto
kopytko	kopyto
kosmyczek	kosmyk
kredensik	kredens
lampeczka	lampa
mszalik	mszał
paszka	pacha
paszka	pacha
pazurek	pazur
pazurek	pazur
pesteczka	pestka
podłostka	podłość
sikoreczka	sikorka
skowroneczek	skowronek
skraweczek	skrawek
strupek	strup
turkaweczka	turkawka
szyszeczka	szyszka
choineczka	choinka
choineczka	choinka
cmentarzyk	cmentarz
badylek	badyl
balecik	balet
balecik	balet
balecik	balet
balecik	balet
dębinka	dębina
dębinka	dębina
dębinka	dębina
szpadelek	szpadel
wilczątko	wilczę
zagonik	zagon
żlebek	żleb
łanek	łan
łanek	łan
łyczko	łyko
wrzecionko	wrzeciono
wrzecionko	wrzeciono
wrzecionko	wrzeciono
wołowinka	wołowina
wołowinka	wołowina
wozik	wóz
wozik	wóz
szantażyk	szantaż
staruszeczka	staruszka
spichlerzyk	spichlerz
rusałeczka	rusałka
rusałeczka	rusałka
prześcieradełko	prześcieradło
pryszczyk	pryszcz
pryszczyk	pryszcz
pryszczyk	pryszcz
projekcik	projekt
projekcik	projekt
projekcik	projekt
pisklątko	pisklę
pióreczko	piórko
pióreczko	piórko
paróweczka	parówka
paróweczka	parówka
paróweczka	parówka
paróweczka	parówka
parczek	park
parczek	park
parczek	park
parczek	park
okrywka	okrywa
okrywka	okrywa
ogródeczek	ogródek
młodzianek	młodzian
matulka	matula
majdanek	majdan
kureczka	kurka
kureczka	kurka
kluczyk	klucz
klarnecik	klarnet
kalinka	kalina
filarek	filar
filarek	filar
dziureczka	dziurka
dzieciąteczko	dzieciątko
dziaduś	dziadek
dziaduś	dziadek
cierniczek	ciernik
chwaścik	chwast
buławka	buława
buławka	buława
capek	cap
celka	cela
celka	cela
dokumencik	dokument
dokumencik	dokument
dokumencik	dokument
dokumencik	dokument
estradka	estrada
intryżka	intryga
klinek	klin
klinik	klin
koliberek	koliber
koncercik	koncert
kurtynka	kurtyna
kwiateczek	kwiatek
likierek	likier
mieszczaneczka	mieszczanka
mosteczek	mostek
obrusik	obrus
parawanik	parawan
pinczerek	pinczer
pulowerek	pulower
płateczek	płatek
płateczek	płatek
rajstopki	rajstopy
rameczka	ramka
rameczka	ramka
skobelek	skobel
spraweczka	sprawka
szkapka	szkapa
talencik	talent
trzewiczek	trzewik
wieprzowinka	wieprzowina
żądełko	żądło
zagródka	zagroda
zagródka	zagroda
zawiasek	zawias
aureolka	aureola
aureolka	aureola
aureolka	aureola
balik	bal
balik	bal
balik	bal
baraninka	baranina
fałdek	fałd
fałdek	fałd
fałdek	fałd
fraczek	frak
wiewióreczka	wiewiórka
welonik	welon
welonik	welon
trawniczek	trawnik
szpaczek	szpak
szpaczek	szpak
szpaczek	szpak
stawik	staw
stawik	staw
stancyjka	stancja
skóreczka	skórka
skóreczka	skórka
skóreczka	skórka
równinka	równina
równinka	równina
rogalik	rogal
pytka	pyta
porteczki	portki
parka	para
parka	para
parka	para
pagóreczek	pagórek
pagóreczek	pagórek
lisiczka	lisica
malinka	malina
malinka	malina
kitelek	kitel
wywiadzik	wywiad
wywiadzik	wywiad
wywiadzik	wywiad
wywiadzik	wywiad
wełnianeczka	wełnianka
wędlinka	wędlina
wąwozik	wąwóz
sztucerek	sztucer
szlarka	szlara
sumik	sum
stojaczek	stojak
pokojóweczka	pokojówka
platforemka	platforma
pelotka	pelota
ołóweczek	ołówek
ołóweczek	ołówek
ołóweczek	ołówek
niemowlątko	niemowlę
mankiecik	mankiet
lampeczka	lampka
krupniczek	krupnik
krupniczek	krupnik
krupka	krupa
knajpeczka	knajpka
korpusik	korpus
korpusik	korpus
kaszelek	kaszel
główeczka	główka
główeczka	główka
główeczka	główka
główeczka	główka
gniewek	gniew
gniewek	gniew
gaździnka	gaździna
drukarenka	drukarnia
brawko	brawo
chałupinka	chałupina
czekanik	czekan
czekanik	czekan
dramacik	dramat
dramacik	dramat
dramacik	dramat
dramacik	dramat
barszczyk	barszcz
barszczyk	barszcz
bóstewko	bóstwo
bóstewko	bóstwo
chrząszczyk	chrząszcz
falka	fala
falka	fala
karpik	karp
koczek	kok
kotuś	kotek
krzaczek	krzak
leszczyk	leszcz
lisek	lis
lisek	lis
naparsteczek	naparstek
naparsteczek	naparstek
naparsteczek	naparstek
organek	organ
organek	organ
organek	organ
pastereczka	pasterka
pidżamka	pidżama
pieseczek	piesek
piwko	piwo
rozumek	rozum
rozumek	rozum
szkatułeczka	szkatułka
wianeczek	wianek
wianeczek	wianek
wianeczek	wianek
łokietek	łokieć
łokietek	łokieć
łokietek	łokieć
apartamencik	apartament
buciczek	bucik
jarzębinka	jarzębina
jarzębinka	jarzębina
kajutka	kajuta
moździerzyk	moździerz
moździerzyk	moździerz
moździerzyk	moździerz
pawik	paw
pawik	paw
piegusek	piegus
plakacik	plakat
powidełko	powidło
przedpokoik	przedpokój
rzeżuszka	rzeżucha
werandka	weranda
tłoczek	tłok
tłoczek	tłok
temacik	temat
temacik	temat
przemówka	przemowa
przemówka	przemowa
bilansik	bilans
bilansik	bilans
brodaweczka	brodawka
brudek	brud
bulweczka	bulwka
bulweczka	bulwka
chrzanik	chrzan
chrzanik	chrzan
chrzanik	chrzan
cygarko	cygaro
kompilacyjka	kompilacja
kompilacyjka	kompilacja
kwestyjka	kwestia
kwestyjka	kwestia
lamka	lama
lamka	lama
nóżeczka	nóżka
nóżeczka	nóżka
oziminka	ozimina
próbeczka	próbka
sprawozdanko	sprawozdanie
szpargalik	szpargał
urlopik	urlop
żyłeczka	żyłka
żyłeczka	żyłka
żyłeczka	żyłka
wyrazik	wyraz
bagażyk	bagaż
belwederek	belweder
belwederek	belweder
bombeczka	bombka
broszeczka	broszka
brydżyk	brydż
brzytewka	brzytwa
fleczek	flek
glonek	glon
glonek	glon
kapeczka	kapka
kawiareczka	kawiarka
kobiałeczka	kobiałka
kwatereczka	kwaterka
kwatereczka	kwaterka
manuskrypcik	manuskrypt
manuskrypcik	manuskrypt
palteczko	paltko
piąsteczka	piąstka
podareczek	podarek
stopeczka	stopka
stopeczka	stopka
światełeczko	światełko
zdróweczko	zdrówko
zdróweczko	zdrówko
żupanek	żupan
łapawiczka	łapawica
akordeonik	akordeon
anegdoteczka	anegdotka
flakoniczek	flakonik
izdebeczka	izdebka
podaruneczek	podarunek
wybryczek	wybryk
wojażyk	wojaż
schemacik	schemat
schemacik	schemat
schemacik	schemat
pularesik	pulares
negliżyk	negliż
myszeczka	myszka
myszeczka	myszka
myszeczka	myszka
myszeczka	myszka
kwiteczek	kwitek
mansardka	mansarda
kropeńka	kropeczka
kropeńka	kropeczka
kropeńka	kropeczka
kropeńka	kropeczka
ćwiarteczka	ćwiartka
ćwiarteczka	ćwiartka
cencik	cent
falsecik	falset
falsecik	falset
fureczka	furka
gumeczka	gumka
gumeczka	gumka
igiełeczka	igiełka
igiełeczka	igiełka
igiełeczka	igiełka
igiełeczka	igiełka
igiełeczka	igiełka
indeksik	indeks
jezioreczko	jeziorko
komplemencik	komplement
koraliczek	koralik
magiereczka	magierka
matuleńka	matulka
nieporządeczek	nieporządek
notateczka	notatka
pochodzik	pochód
pochodzik	pochód
posmaczek	posmak
posmaczek	posmak
pożarek	pożar
pożarek	pożar
pożarek	pożar
przysiadek	przysiad
pupeczka	pupka
sarniątko	sarnię
scyzoryczek	scyzoryk
świneczka	świnka
tendencyjka	tendencja
tendencyjka	tendencja
tendencyjka	tendencja
wzroczek	wzrok
wzroczek	wzrok
żyteczko	żytko
żyteczko	żytko
bamboszek	bambosz
baniaczek	baniak
baniaczek	baniak
baniaczek	baniak
chabetka	chabeta
czółeczko	czółko
czółeczko	czółko
fetorek	fetor
garbik	garb
garbik	garb
jedliczka	jedlica
jednoaktóweczka	jednoaktówka
karbik	karb
karbik	karb
klameczka	klamka
konarek	konar
konarek	konar
koncesyjka	koncesja
koncesyjka	koncesja
kufereczek	kuferek
maderka	madera
maderka	madera
maderka	madera
malowidełko	malowidło
mantolecik	mantolet
maszcik	maszt
maszcik	maszt
miedziaczek	miedziak
przytulijka	przytulia
rudka	ruda
rumik	rum
sośninka	sośnina
sośninka	sośnina
sośninka	sośnina
stóweczka	stówka
szałasik	szałas
szałasik	szałas
tranzystorek	tranzystor
tranzystorek	tranzystor
uklejka	ukleja
wełniaczek	wełniak
wełniaczek	wełniak
wełniaczek	wełniak
wirydarzyk	wirydarz
wulkanizatorek	wulkanizator
antałeczek	antałek
bankiecik	bankiet
bankiecik	bankiet
drobniaczek	drobniak
dziwolążek	dziwoląg
gardełko	gardło
góraleczka	góralka
grabinka	grabina
grabinka	grabina
grzmocik	grzmot
grzmocik	grzmot
hafcik	haft
hafcik	haft
jasełeczka	jasełka
knocik	knot
kolebeczka	kolebka
kolebeczka	kolebka
kolebeczka	kolebka
kreaturka	kreatura
kuponik	kupon
kuponik	kupon
dynastyjka	dynastia
facecyjka	facecja
facecyjka	facecja
frontonik	fronton
frontonik	fronton
halsztuczek	halsztuk
kondensatorek	kondensator
kondensatorek	kondensator
korcik	kort
nożynka	nożyna
potrzebka	potrzeba
potrzebka	potrzeba
raptularzyk	raptularz
raptularzyk	raptularz
substancyjka	substancja
sukcesyjka	sukcesja
sukcesyjka	sukcesja
węgarek	węgar
żaluzyjka	żaluzja
łanik	łan
łanik	łan
łojóweczka	łojówka
łojóweczka	łojówka
dyscyplinka	dyscyplina
dyscyplinka	dyscyplina
dyscyplinka	dyscyplina
gnacik	gnat
gnacik	gnat
kolonik	kolon
żlebik	żleb
kłobuczek	kłobuk
kłobuczek	kłobuk
kłobuczek	kłobuk
kłobuczek	kłobuk
lupka	lupa
numereczek	numerek
numereczek	numerek
orderek	order
ostrewka	ostrew
pensjonareczka	pensjonarka
perkaliczek	perkalik
plecioneczka	plecionka
plecioneczka	plecionka
polerek	poler
portreciczek	portrecik
półgodzinka	półgodzina
prąteczek	prątek
przedmówka	przedmowa
rezydencyjka	rezydencja
rydelek	rydel
ślepeczek	ślepek
szeleczka	szelka
terminarzyk	terminarz
terminarzyk	terminarz
toaścik	toast
trzaseczka	trzaska
wiązeczka	wiązka
wiązeczka	wiązka
wyziewek	wyziew
biedroneczka	biedronka
buczynka	buczyna
bufecik	bufet
bufecik	bufet
dzieweńka	dzieweczka
frazesik	frazes
grobeleczka	grobelka
herbik	herb
jabłkóweczka	jabłkówka
kąteczek	kątek
kąteczek	kątek
komineczek	kominek
komineczek	kominek
kropeleczka	kropelka
kropeleczka	kropelka
kwietniczek	kwietnik
lichewka	lichwa
menuecik	menuet
menuecik	menuet
mikserek	mikser
mikserek	mikser
młyneczek	młynek
młyneczek	młynek
obławka	obława
obławka	obława
ostróżeczka	ostróżka
półgłosek	półgłos
protokólik	protokół
protokólik	protokół
rachuneczek	rachunek
rachuneczek	rachunek
rachuneczek	rachunek
remoncik	remont
rewersik	rewers
rewersik	rewers
rewersik	rewers
rewersik	rewers
ruderka	rudera
siewniczek	siewnik
śpiewniczek	śpiewnik
szpalerek	szpaler
szpalerek	szpaler
traweczka	trawka
traweczka	trawka
zgrzycik	zgrzyt
żołądeczek	żołądek
bylinka	bylina
bylinka	bylina
chlebaczek	chlebak
ciurek	ciur
delijka	delia
dzióbeczek	dzióbek
duserek	duser
dworeczek	dworek
kapilarka	kapilara
kawaląteczek	kawalątek
kawaląteczek	kawalątek
klamereczka	klamerka
mikrofonik	mikrofon
miłosteczka	miłostka
pantalonki	pantalony
pantalonki	pantalony
piórniczek	piórnik
pisaneczka	pisanka
pisaneczka	pisanka
postawka	postawa
postawka	postawa
prądzik	prąd
prądzik	prąd
prądzik	prąd
skarbik	skarb
skarbik	skarb
spekulacyjka	spekulacja
spekulacyjka	spekulacja
szaberek	szaber
szaberek	szaber
szaberek	szaber
szepcik	szept
szepcik	szept
szronik	szron
szwagiereczka	szwagierka
ukłonik	ukłon
zwyczaik	zwyczaj
żłobeczek	żłobek
żłobeczek	żłobek
żłobeczek	żłobek
żłobeczek	żłobek
łepeczek	łepek
arsenalik	arsenał
arsenalik	arsenał
banderolka	banderola
bandurka	bandura
biuścik	biust
emblemacik	emblemat
emblemacik	emblemat
furmaneczka	furmanka
gondolka	gondola
gondolka	gondola
gondolka	gondola
inhalatorek	inhalator
kąseczek	kąsek
kolekcyjka	kolekcja
kolekcyjka	kolekcja
koleżaneczka	koleżanka
kondycyjka	kondycja
kondycyjka	kondycja
kondycyjka	kondycja
koszulinka	koszulina
miksturka	mikstura
miksturka	mikstura
oryginalik	oryginał
plameczka	plamka
podmuszek	podmuch
podmuszek	podmuch
podmuszek	podmuch
pomostek	pomost
pomostek	pomost
pomostek	pomost
pomostek	pomost
procencik	procent
procencik	procent
procencik	procent
tużureczek	tużurek
wędzoneczka	wędzonka
bandolecik	bandolet
bandolecik	bandolet
bastionik	bastion
busolka	busola
dębniaczek	dębniak
delegacyjka	delegacja
fundamencik	fundament
fundamencik	fundament
galimatiasik	galimatias
gotóweczka	gotówka
grymasik	grymas
harcapik	harcap
harcapik	harcap
hołotka	hołota
impresyjka	impresja
kabinecik	kabinet
karykaturka	karykatura
karykaturka	karykatura
komisyjka	komisja
komisyjka	komisja
koncepcik	koncept
koncepcik	koncept
motywik	motyw
motywik	motyw
motywik	motyw
munsztuczek	munsztuk
plotkareczka	plotkarka
podwiązeczka	podwiązka
podwiązeczka	podwiązka
poszeweczka	poszewka
problemacik	problemat
prowizyjka	prowizja
sztambuszek	sztambuch
szwindelek	szwindel
topolka	topola
wypadeczek	wypadek
wypadeczek	wypadek
wypadeczek	wypadek
winiarenka	winiarnia
winiarenka	winiarnia
wytwórenka	wytwórnia
żalik	żal
żalik	żal
żalik	żal
zawijasek	zawijas
zawijasek	zawijas
aromacik	aromat
aromacik	aromat
bagnecik	bagnet
bandażyk	bandaż
cięciwka	cięciwa
cięciwka	cięciwa
dwójeczka	dwójka
dwójeczka	dwójka
dwójeczka	dwójka
dwójeczka	dwójka
efekcik	efekt
efekcik	efekt
efekcik	efekt
gnieciuszek	gnieciuch
godzineczka	godzinka
gradzinka	gradzina
igielniczek	igielnik
klątewka	klątwa
kombinacyjka	kombinacja
kombinacyjka	kombinacja
kompleksik	kompleks
kompleksik	kompleks
kompleksik	kompleks
koszuleczka	koszulka
koszuleczka	koszulka
kryminalik	kryminał
kryminalik	kryminał
marzaneczka	marzanka
monumencik	monument
monumencik	monument
mościk	most
pacholątko	pacholę
pretensyjka	pretensja
pretensyjka	pretensja
płoneczka	płonka
płoneczka	płonka
rafka	rafa
rafka	rafa
rafka	rafa
rewolucyjka	rewolucja
rewolucyjka	rewolucja
szpuleczka	szpulka
szpuleczka	szpulka
sztabik	sztab
sztabik	sztab
tamburek	tambur
tawułka	tawuła
transparencik	transparent
audycyjka	audycja
ażurek	ażur
ażurek	ażur
częborek	cząber
czaszeczka	czaszka
czaszeczka	czaszka
dąsik	dąs
dubeltóweczka	dubeltówka
floresik	flores
gadzinka	gadzina
gadzinka	gadzina
gadzinka	gadzina
gąseczka	gąska
kasarek	kasar
kminkóweczka	kminkówka
komforcik	komfort
komforcik	komfort
kordonik	kordon
kostiumek	kostium
kostiumek	kostium
kostiumek	kostium
kurancik	kurant
kurancik	kurant
kurancik	kurant
kwiaciarenka	kwiaciarnia
kłosik	kłos
lekcyjka	lekcja
lekcyjka	lekcja
lekcyjka	lekcja
maślaczek	maślak
mgiełeczka	mgiełka
mgiełeczka	mgiełka
muszeczka	muszka
ochłapek	ochłap
ochłapek	ochłap
odrobineczka	odrobinka
owiesek	owies
owiesek	owies
przygódka	przygoda
przygódka	przygoda
przygódka	przygoda
pustułeczka	pustułka
rybeczka	rybka
rybeczka	rybka
skrzelka	skrzela
szpadrynka	szpadryna
szpargałek	szpargał
urazik	uraz
zadateczek	zadatek
zadateczek	zadatek
dybki	dyby
dzbaneczek	dzbanek
falbaneczka	falbanka
flircik	flirt
flircik	flirt
karawanik	karawan
karawanik	karawan
kodycylek	kodycyl
krzyżyczek	krzyżyk
krzyżyczek	krzyżyk
krzyżyczek	krzyżyk
kutnerek	kutner
miareczka	miarka
miareczka	miarka
miareczka	miarka
parkanik	parkan
pomarańczka	pomarańcza
pomarańczka	pomarańcza
postumencik	postument
półsłóweczko	półsłówko
przystaneczek	przystanek
pstrążek	pstrąg
rotundka	rotunda
rotundka	rotunda
rotundka	rotunda
sesyjka	sesja
skakaneczka	skakanka
skakaneczka	skakanka
snopeczek	snopek
specjalik	specjał
słoneczka	słonka
ustępik	ustęp
ustępik	ustęp
wdóweczka	wdówka
wierszyczek	wierszyk
wióreczek	wiórek
wytryszek	wytrych
autoportrecik	autoportret
autoportrecik	autoportret
brzeżeczek	brzeżek
buhajek	buhaj
deklinacyjka	deklinacja
deklinacyjka	deklinacja
koniugacyjka	koniugacja
koniugacyjka	koniugacja
dytyrambik	dytyramb
dytyrambik	dytyramb
dytyrambik	dytyramb
elaboracik	elaborat
gąszczyk	gąszcz
gąszczyk	gąszcz
gąszczyk	gąszcz
hebelek	hebel
jesioneczka	jesionka
jeżynka	jeżyna
jeżynka	jeżyna
kiecuszka	kiecka
korepetycyjka	korepetycja
makrelka	makrela
marmeladka	marmelada
okazyjka	okazja
pogódka	pogoda
pogódka	pogoda
pogódka	pogoda
posturka	postura
protekcyjka	protekcja
strzałeczka	strzałka
strzałeczka	strzałka
strzałeczka	strzałka
strzałeczka	strzałka
szlabanik	szlaban
szlabanik	szlaban
szlabanik	szlaban
szpinaczek	szpinak
trapik	trap
trójnóżek	trójnóg
trójnóżek	trójnóg
trójnóżek	trójnóg
wanieneczka	wanienka
wanieneczka	wanienka
wiśnióweczka	wiśniówka
wiśnióweczka	wiśniówka
wypałek	wypał
wypałek	wypał
wzmianeczka	wzmianka
żeleźniaczek	żeleźniak
zgniotek	zgniot
zgryzotka	zgryzota
ziółeczko	ziółko
łebeczek	łebek
łebeczek	łebek
barchanik	barchan
brzemionko	brzemię
brzemionko	brzemię
członeczek	członek
dłuteczko	dłutko
ekwipażyk	ekwipaż
frykasik	frykas
fryzka	fryza
haremik	harem
kroczek	krok
kroczek	krok
kroczek	krok
lurka	lura
manelka	manela
marynatka	marynata
marynatka	marynata
masażyk	masaż
mątewka	mątwa
minarecik	minaret
parcelka	parcela
pigułeczka	pigułka
podkóweczka	podkówka
podkóweczka	podkówka
podkóweczka	podkówka
segmencik	segment
segmencik	segment
segmencik	segment
szlemiczek	szlemik
szmateczka	szmatka
szmateczka	szmatka
zawalik	zawał
zawalik	zawał
łamigłóweczka	łamigłówka
akcik	akt
akcik	akt
argumencik	argument
argumencik	argument
argumencik	argument
atlasik	atlas
atlasik	atlas
awansik	awans
awansik	awans
banderka	bandera
czarcikęsik	czarcikęs
grzyweczka	grzywka
klanik	klan
klanik	klan
klanik	klan
konflikcik	konflikt
konstytucyjka	konstytucja
króciczka	krócica
meczecik	meczet
oleodruczek	oleodruk
partaninka	partanina
perzyk	perz
petardka	petarda
petardka	petarda
posesyjka	posesja
prawidełko	prawidło
prawidełko	prawidło
procesik	proces
procesik	proces
procesik	proces
protokolik	protokół
protokolik	protokół
pociążek	pociąg
pociążek	pociąg
przylepeczka	przylepka
przylepeczka	przylepka
płetewka	płetwa
płetewka	płetwa
płetewka	płetwa
rozkazik	rozkaz
siurpryzka	siurpryza
śmietaneczka	śmietanka
śmietaneczka	śmietanka
skrzeczek	skrzek
skrzeczek	skrzek
strzelbka	strzelba
szalupka	szalupa
łapinka	łapina
łapinka	łapina
akcydensik	akcydens
alegoryjka	alegoria
alegoryjka	alegoria
apetycik	apetyt
apetycik	apetyt
apetycik	apetyt
araczek	arak
banczek	bank
dynamomaszynka	dynamomaszyna
fortepianik	fortepian
haczek	hak
haczek	hak
kaprysik	kaprys
kaprysik	kaprys
kurytarzyk	kurytarz
kwotka	kwota
naturka	natura
naturka	natura
obietniczka	obietnica
okólniczek	okólnik
pliczek	plik
pliczek	plik
poglądzik	pogląd
preferansik	preferans
redutka	reduta
specjałek	specjał
szafareczka	szafarka
szwadronik	szwadron
tarciczka	tarcica
tarciczka	tarcica
turkusik	turkus
turkusik	turkus
tygodniczek	tygodnik
wądołek	wądół
wądołek	wądół
wydateczek	wydatek
zasiewek	zasiew
zasiewek	zasiew
dorszyk	dorsz
familijka	familia
gruncik	grunt
gruncik	grunt
głazik	głaz
hełmik	hełm
hełmik	hełm
jameczka	jamka
jameczka	jamka
jameczka	jamka
kokonik	kokon
kokonik	kokon
kolibka	koliba
komunikacik	komunikat
kordiałek	kordiał
krepinka	krepina
krepinka	krepina
krepinka	krepina
księgozbiorek	księgozbiór
mankamencik	mankament
poleweczka	polewka
powrósełko	powrósło
promik	prom
refektarzyk	refektarz
remanencik	remanent
roik	rój
trumniaczek	trumniak
trumniaczek	trumniak
wiszorek	wiszor
wujeneczka	wujenka
wzgóreczek	wzgórek
włoseczek	włosek
zrąbek	zrąb
zrąbek	zrąb
zrąbek	zrąb
łateczka	łatka
łateczka	łatka
łazieneczka	łazienka
cudaczek	cudak
czwartaczek	czwartak
demonek	demon
diuczek	diuk
diuczek	diuk
grajcarek	grajcar
grajcarek	grajcar
grajcarek	grajcar
głuptaczek	głuptak
głuptaczek	głuptak
kuzyneczek	kuzynek
liliputek	liliput
mieszczuszek	mieszczuch
mniszeczek	mniszek pospolity
obereczek	oberek
obereczek	oberek
omlecik	omlet
papierosik	papieros
przedszkolaczek	przedszkolak
rubelek	rubel
soliterek	soliter
soliterek	soliter
strzemionko	strzemię
strzemionko	strzemię
żubrek	żubr
żonkilek	żonkil
zbirek	zbir
wielbłądek	wielbłąd
amancik	amant
blondyneczek	blondynek
bobasek	bobas
ptaszeczek	ptaszek
ptaszeczek	ptaszek
pelikanik	pelikan
obarzaneczek	obarzanek
nochalek	nochal
morusek	morus
kulfonik	kulfon
kulfonik	kulfon
księżulko	księżulo
księżulek	księżulo
księżunio	ksiądz
koziołeczek	koziołek
koziołeczek	koziołek
koziołeczek	koziołek
denarek	denar
dziwotworek	dziwotwór
figielek	figiel
gburek	gbur
koniczek	konik
koniczek	konik
bachmacik	bachmat
batalionik	batalion
batalionik	batalion
batalionik	batalion
czarcik	czart
foksterierek	foksterier
funcik	funt
funcik	funt
garbusik	garbus
klocuszek	klocek
klocuszek	klocek
koczkodanik	koczkodan
lizaczek	lizak
lizaczek	lizak
muzykancik	muzykant
pilocik	pilot
staruszeczek	staruszek
świetliczek	świetlik
świetliczek	świetlik
zdechlaczek	zdechlak
befsztyczek	befsztyk
bizonek	bizon
bizonek	bizon
chrześniaczek	chrześniak
dromaderek	dromader
fiołeczek	fiołek
gadzik	gad
gniotek	gniot
gniotek	gniot
kanareczek	kanarek
młokosik	młokos
wstręciuszek	wstręciuch
wnuczuś	wnuczek
baraneczek	baranek
baraneczek	baranek
baraneczek	baranek
judaszek	judasz
judaszek	judasz
pierwszaczek	pierwszak
skarbek	skarb
skarbek	skarb
wyżełek	wyżeł
ząbeczek	ząbek
żaczek	żak
cherlaczek	cherlak
cherlaczek	cherlak
hajduczek	hajduk
hajduczek	hajduk
hajduczek	hajduk
indorek	indor
jasieczek	jasiek
kujawiaczek	kujawiak
kupidynek	kupidyn
pedancik	pedant
pędraczek	pędrak
pędraczek	pędrak
skorpionik	skorpion
szlamik	szlam
uparciuszek	uparciuch
znamionko	znamię
łoszaczek	łoszak
drewniaczek	drewniak
komediancik	komediant
komediancik	komediant
koziełek	kozieł
krąpik	krąp
pastuszek	pastuch
pismaczek	pismak
polonezik	polonez
polonezik	polonez
poruczniczek	porucznik
sztosik	sztos
trzeciaczek	trzeciak
warchlaczek	warchlak
warchlaczek	warchlak
ziarnuszko	ziarnko
ablegierek	ablegier
bażancik	bażant
guziczuszek	guziczek
kadecik	kadet
krewniaczek	krewniak
kulasek	kulas
kulasek	kulas
lazurek	lazur
lazurek	lazur
mizeraczek	mizerak
nagusek	nagus
natręcik	natręt
ogrodniczek	ogrodnik
tapirek	tapir
tapirek	tapir
trzcinniczek	trzcinnik
tygrysek	tygrys
tupecik	tupet
dziadulek	dziad
gracik	grat
kaweczka	kawka
kaweczka	kawka
motecik	motet
piruecik	piruet
siniaczek	siniak
kulka	kula
głuptaś	głuptas
lirka	lira
pyrka	pyra
pyrka	pyra
sadzaweczka	sadzawka
sadzaweczka	sadzawka
czynnostka	czynność
dogodnostka	dogodność
grzecznostka	grzeczność
niegrzecznostka	niegrzeczność
nieprzyjemnostka	nieprzyjemność
kwartecik	kwartet
kwartecik	kwartet
patencik	patent
truśka	trusia
zieleniaczek	zieleniak
zieleniaczek	zieleniak
zaduszek	zaduch
akcencik	akcent
akcencik	akcent
gradowinka	gradowina
cholewka	cholewa
próbka	próba
mydełko	mydło
loteryjka	loteria
ankietka	ankieta
ankietka	ankieta
objemka	obejma
obłamek	obłam
zagonek	zagon
komciaczek	komcio
pigułka	piguła
widełki	widły
bibułka	bibuła
papierek	papier
bibułka	bibuła
fajeczka	fajka
pieścidełko	pieścidło
smrodzik	smród
bruzdka	bruzda
pacyfka	pacyfa
żydek	żyd
serek	ser
obrywek	obryw
stawek	staw
kamerka	kamera
obórka	obora
stoczek	stok
stoczek	stok
uważka	uwaga
uważka	uwaga
uważka	uwaga
pierożek	pieróg
żeberko	żebro
żeberko	żebro
kokilka	kokila
kolaseczka	kolaska
matusia	matula
parapecik	parapet
wujcio	wujko
słoneczko	słonko
karniaczek	karniak
lamusek	lamus
łobuziaczek	łobuziak
panienka	panna
dziadziuś	dziadek
mężateczka	mężatka
koczkodanek	koczkodan
Bydzia	Bydgoszcz
kiciuś	kicia
koteniek	kotek
słabiaczek	słabiak
dupeczka	dupa
pierdółka	pierdoła
chudzinka	chudzina
fiacik	fiat
beczka	beka
pucka	puca
pućka	pucka
grubcio	gruby
bidulka	bidula
bidusia	bidula
czubek	czub
skarbeczek	skarbek
skarbeniek	skarbek
skarbulek	skarbek
rybcia	rybka
zakonniczka	zakonnica
graficzka	grafika
winietka	winieta
konik na biegunach	koń na biegunach
książka	księga
Wrocek	Wrocław
Wawka	Wawa
kapturek	kaptur
kapturek	kaptur
koszulka	koszula
osłonka	osłona
grosik	grosz
cekinek	cekin
pensiak	pens
dwójeczka	dwójka
dwójeczka	dwójka
dwójeczka	dwójka
dwójeczka	dwójka
trójeczka	trójka
trójeczka	trójka
trójeczka	trójka
trójeczka	trójka
trójeczka	trójka
trójeczka	trójka
mazurek	mazur
mazurek	mazur
poleczka	polka
sztajerek	sztajer
balecik	balet
kroczek	krok
motylek	motyl
nutka	nuta
brzuszek	brzuch
anyżek	anyż
frotka	frota
szewczyk	szewc
śliwka	śliwa
mrozek	mróz
łabędzik	łabędź
krecik	kret
bryjka	bryja
misiaczek	miś
misiaczek	miś
gąska	gęś
płachetka	płachta
kożuszek	kożuch
huczek	huk
pupcia	pupa
jarzynka	jarzyna
żoncia	żonka
papryczka chili	papryka chili
źrebiczek	źrebiec
źrebiczka	źrebica
alkówka	alkowa
czamarka	czamara
czambulik	czambuł
kołaczyk	kołacz
żłóbeczek	żłóbek
fasolka szparagowa	fasola szparagowa
szyszka	szycha
ziarenko	ziarno
ziarnko	ziarno
ziarnko	ziarno
ziarenko	ziarno
ziarnko	ziarno
wyżynka	wyżyna
kwiatek	kwiat
flakonik	flakon
kwiatuszek	kwiatek
kwiatuszek	kwiatek
anyżek	anyż
szczypiorek	szczypior
blaszka	blacha
blaszka	blacha
zapałeczka	zapałka
zapałeczka	zapałka
szprycka	szpryca
zasobniczek	zasobnik
zbójniczek	zbójnik
kartofelek	kartofel
truchełko	truchło
trufelka	trufla
trufelka	trufla
trykocik	trykot
szwaczusia	szwaczka
boczek	bok
słoniczka	słonica
trzpiotek	trzpiot
chlewek	chlew
skrzydełko	skrzydło
tabakiereczka	tabakierka
skrzydełko	skrzydło
królik	król
gumka	guma
gumka	guma
taksóweczka	taksówka
tartaczek	tartak
tasiemeczka	tasiemka
móżdżek	mózg
polędwiczka	polędwica
tyralierka	tyraliera
temperamencik	temperament
temperamencik	temperament
smrodek	smród
smrodek	smród
walczyk	walc
walczyk	walc
walczyk	walc
uprzejmostka	uprzejmość
domina	dom
kubeczek	kubek
minka	mina
wzorek	wzór
wzorek	wzór
samurka	samura
kuchenka	kuchnia
żarełko	żarło
herbatka	herbata
herbatka	herbata
wiścik	wist
wieszaczek	wieszak
schabik	schab
seryjka	seria
cymbałek	cymbał
tronik	tron
seteczka	setka
wódeczka	wódka
piwko	piwo
browarek	browar
sienniczek	siennik
siermiężka	siermięga
sieroteńka	sierota
kościołek	kościół
siwoszek	siwosz
skafanderek	skafander
skafanderek	skafander
flaszeczka	flaszka
wizawka	wizawa
więciorek	więcierz
wiązadełko	wiązadło
więzadełko	więzadło
skuterek	skuter
sukmanka	sukmana
sunia	suka
suwaczek	suwak
soszka	socha
dochodzik	dochód
fałdzik	fałd
raczyna	rak
westka	westa
wezgłówek	wezgłowie
porterek	porter
spodeńki	spodnie
kubeczek	kubek
kubeczek	kubek
kubeczek	kubek
spryciarka	spryciara
sprycik	spryt
posażek	posag
postroneczek	postronek
mendelek	mendel
stągiewka	stągiew
sosik	sos
pamiąteczka	pamiątka
pampuszek	pampuch
pampuszek	pampuch
mikrobusik	mikrobus
stopieniek	stopień
straszydełko	straszydło
strucelka	strucla
witrynka	witryna
witrynka	witryna
papilotek	papilot
papilotek	papilot
paputek	papuć
piętka	pięta
dupcia	dupa
dupeczka	dupa
dupeczka	dupka
sznytka	sznyta
mniszeczka	mniszka
stopka	stopa
parobeczek	parobek
parostateczek	parostatek
parowek	parów
miseczka	miska
patelka	patelnia
pejczyk	pejcz
mordeczka	mordka
mordeczka	mordka
śrubeczka	śrubka
lusterko	lustro
lusterko	lustro
ziarneczko	ziarnko
ziarneczko	ziarnko
ziarneczko	ziarnko
obrusek	obrus
jaszczureczka	jaszczurka
łuczywko	łuczywo
patelenka	patelnia
kąpiołka	kąpiel
kęsik	kęs
łosik	łoś
łopateczka	łopatka
łopateczka	łopatka
łopateczka	łopatka
łopateczka	łopatka
łopateczka	łopatka
łobuzek	łobuz
ancymonek	ancymon
łapeczka	łapka
łapeczka	łapka
kryminałek	kryminał
kryminałek	kryminał
kryniczka	krynica
promionek	promień
przebudówka	przebudowa
kukiełeczka	kukiełka
wrzodzik	wrzód
ocio	oko
oczątko	oczko
odcineczek	odcinek
mieścinka	mieścina
mieścinka	mieścina
ogieniaszek	ogień
ojcaszek	ojciec
ojcaszek	ojciec
ojczuś	ojciec
ojczuś	ojciec
okieneczko	okno
okienniczka	okiennica
lamusik	lamus
lamusik	lamus
kusztyczek	kusztyk
kusztyczek	kusztyk
ochotka	ochota
ochotka	ochota
musik	mus
małpiątko	małpię
olsterko	olstro
mikrokryształek	mikrokryształ
onuczka	onuca
ptifurki	ptifury
liczydełko	liczydło
salopka	salopa
operacyjka	operacja
młynareczka	młynarka
lirenka	lira
szprycka	szpryca
szprycka	szpryca
paletka	paleta
adiutancik	adiutant
adresik	adres
machinka	machina
namiętnostka	namiętność
matunia	matka
pałeczka	pałka
narządko	narzędzie
wodniczek	wodnik
góreczka	górka
gulka	gula
głodomorek	głodomór
główeńka	główka
głowinka	głowina
hajdawerki	hajdawery
niecułka	niecka
niecułka	niecka
rogóżka	rogoża
półkolumienka	półkolumna
przykładzik	przykład
armijka	armia
aronek	aron
asik	as
pasieczka	pasieka
hufczyk	hufiec
otomanka	otomana
otrąbki	otręby
otrąbki	otręby
owadek	owad
buduarek	buduar
balijka	balia
pościelówka	pościelówa
pałączek	pałąk
pupina	pupa
brzoskwinka	brzoskwinia
cieliczka	cielica
szmerek	szmer
baskinka	baskina
izbeczka	izba
pępuszek	pępek
bazarek	bazar
bałagułka	bałaguła
bekieszka	bekiesza
berżerka	berżera
kaparek	kapar
kapciuszek	kapeć
kapeńka	kapka
różdżka	rózga
szyfonierka	szyfoniera
parowozik	parowóz
regalik	regał
kapinka	kapka
kaletka	kaleta
pólko	pole
przygródek	gródek
prześmiechy	prześmieszki
źrebiątko	źrebię
kawiorek	kawior
kałamarzyk	kałamarz
kałamarzyk	kałamarz
kałużka	kałuża
fantazyjka	fantazja
fałdeczka	fałdka
jupeczka	jupka
gęśliczka	gęśliki
kacabajka	kacabaja
bocheneczek	bochenek
galonik	galon
galonik	galon
galonik	galon
gatki	gacie
gatki	gacie
kikucik	kikut
kikucik	kikut
kabacik	kabat
kapotka	kapota
kapotka	kapota
kontusik	kontusz
koroneczka	koronka
koroneczka	koronka
koroneczka	koronka
kudełki	kudły
kudełki	kudły
kisielek	kisiel
kistka	kiść
kistka	kiść
kadzielniczka	kadzielnica
kancelaryjka	kancelaria
klosik	klosz
kloszyk	klosz
czupiradełko	czupiradło
damusia	dama
kokotka	kokota
kolonijka	kolonia
kolonijka	kolonia
kompanijka	kompania
kompanijka	kompania
kondemnatka	kondemnata
blizenka	blizna
bożątko	bożę
bożek	bóg
koniuszczek	koniec
brzękadełko	brzękadło
brzuś	brzuch
brzuszyna	brzuch
bulwarek	bulwar
ścieżek	ścieg
dowcipuszek	dowcip
dowcipuszek	dowcip
chateńka	chatka
lodzik	lód
jęzorek	jęzor
paltocik	paltot
pluderki	pludry
pszeniczka	pszenica
skarpeteczka	skarpetka
sukienko	sukno
deszczułeczka	deszczułka
zameczek	zamek
zameczek	zamek
borek	bór
groń	grosz
kotarka	kotara
korzonek	korzeń
wazka	waza
wazka	waza
wełenka	wełna
wełenka	wełna
wełenka	wełna
wierzbka	wierzba
zegareczek	zegarek
rutka	ruta
cybuszek	cybuch
choróbka	choroba
koziczek	kozik
karcięta	karty
pluderki	pludry
foksik	foks
forcik	fort
fotografijka	fotografia
kistka	kiszka
ścianka	ściana
chwilunia	chwila
gaiczek	gaik
geniuszek	geniusz
cielęcinka	cielęcina
dyszkancik	dyszkant
dyszkancik	dyszkant
dyszkancik	dyszkant
dyszkancik	dyszkant
forcik	fort
gaik	gaj
glorietka	glorieta
glorietka	glorieta
goloneczka	golonka
gołębiczka	gołębica
gołębiczka	gołębica
grypka	grypa
płużek	pług
okrzosek	okrzos
przewodzik	przewód
przewodzik	przewód
przewodzik	przewód
płócienko	płótno
płócienko	płótno
rozdzialik	rozdział
spencerek	spencer
sznycelek	sznycel
wężyk	wąż
czeladniczek	czeladnik
czerpaczek	czerpak
rejestrzyk	rejestr
reklamka	reklama
roberek	rober
reportażyk	reportaż
reportażyk	reportaż
serweteczka	serwetka
serweteczka	serwetka
szynczek	szynk
upłazek	upłaz
dekolcik	dekolt
goloneczka	golonka
pisemko	pismo
rączuchna	rączka
rozwórka	rozwora
ryneczka	rynka
falka	fala
kożuszek	kożuch
uszko	ucho
uszko	ucho
podkówka	podkowa
sygnałek	sygnał
piesio	pies
pysio	pysk
marmurek	marmur
krakowiaczek	krakowiak
Krakowiaczek	Krakowiak
muszkatelka	muszkatela
skrzyneczka	skrzynka
pajączek	pająk
bombonierka	bomboniera
teatrzyk	teatr
temacik	temat
temacik	temat
futerko	futro
norka	nora
roladka	rolada
gniazdko	gniazdo
różek	róg
rożek	róg
wafelek	wafel
pasztecik	pasztet
płatek	płat
płateczek	płatek
pychotka	pychota
przydaszek	przydach
krzyżyk	krzyż
krzyżyk	krzyż
krzyżyk	krzyż
rzęska	rzęsa
smoczek	smok
skórka	skóra
tarczka	tarcza
tarczka	tarcza
tarczka	tarcza
tarczka	tarcza
tarczka	tarcza
piramidka	piramida
piramidka	piramida
lujek	luj
pieszczoszek	pieszczoch
kropeczka	kropka
pepiczek	pepik
niemiaszek	Niemiec
meczyk	mecz
żyłka	żyła
fejsik	fejs
pachołek	pachoł
łabądek	łabędź
garnuszek	garnek
kijek	kij
bąbelek	bąbel
żyłka	żyła
młoteczek	młotek
brzoskwinka	brzoskwinia
szklaneczka	szklanka
talerzyk	talerz
patelka	patelnia
antałek	antał
cukierniczka	cukiernica
wazonik	wazon
wiaderko	wiadro
kubełek	kubeł
słoiczek	słoik
miedniczka	miednica
wanieneczka	wanienka
karafeczka	karafka
wazka	waza
wazka	waza
kufelek	kufel
kompotierka	kompotiera
dzbanuszek	dzbanek
czareczka	czarka
nocniczek	nocnik
basenik	basen
kolbka	kolba
baryłeczka	baryłka
balijka	balia
rondelek	rondel
tygielek	tygiel
czajniczek	czajnik
brytfanka	brytfanna
kałamarzyk	kałamarz
gąsiorek	gąsior
kasztanek	kasztan
kartonik	karton
pojemniczek	pojemnik
puszeczka	puszka
paczuszka	paczka
włókienko	włókno
korzonek	korzeń
kwasek	kwas
rozetka	rozeta
bachorek	bachor
kadzielniczka	kadzielnica
dzbaneczek	dzbanek
dzieżka	dzieża
garnczek	garnek
antałeczek	antałek
kuwetka	kuweta
poidełko	poidło
pojniczek	pojnik
garnuszeczek	garnuszek
pozłotka	pozłota
niedźwiadek polarny	niedźwiedź polarny
kanapka	kanapa
żywe sreberko	żywe srebro
śmiechaweczka	śmiechawka
śmiechóweczka	śmiechówka
stacyjka	stacja
listek	liść
maczek	mak
kratki	kraty
graficzka	grafika
miniaturka	miniatura
puszek	puch
puszek	puch
łańcuszek	łańcuch
łańcuszek	łańcuch
łańcuszek	łańcuch
krafcik	kraft
