Prezesem	prezes	subst:sg:inst:m1
Towarzystwa	towarzystwo	subst:sg:gen:n
Muzycznego	muzyczny	adj:sg:gen:n:pos
jednogłośnie	jednogłośnie	adv:pos
został	zostać	praet:sg:m1:perf
wybrany	wybrać	ppas:sg:nom:m1:perf:aff
Andrzej	Andrzej	subst:sg:nom:m1
Wituski	Wituski	subst:sg:nom:m1
,	,	interp
były	były	adj:sg:nom:m1:pos
prezydent	prezydent	subst:sg:nom:m1
Poznania	Poznań	subst:sg:gen:m3
.	.	interp
Będzie	być	bedzie:sg:ter:imperf
kierował	kierować	praet:sg:m1:imperf
on	on	ppron3:sg:nom:m1:ter:akc:npraep
towarzystwem	towarzystwo	subst:sg:inst:n
do	do	prep:gen
2007	2007	adj:sg:gen:m3:pos
roku	rok	subst:sg:gen:m3
.	.	interp
Walne	walny	adj:sg:nom:n:pos
zgromadzenie	zgromadzenie	subst:sg:nom:n
członków	członek	subst:pl:gen:m1
było	być	praet:sg:n:imperf
znakomitą	znakomity	adj:sg:inst:f:pos
okazją	okazja	subst:sg:inst:f
do	do	prep:gen
podsumowania	podsumować	ger:sg:gen:n:perf:aff
działalności	działalność	subst:sg:gen:f
towarzystwa	towarzystwo	subst:sg:gen:n
w	w	prep:loc:nwok
kończącej	kończyć	pact:sg:loc:f:imperf:aff
się	się	qub
kadencji	kadencja	subst:sg:loc:f
.	.	interp
W	w	prep:loc:nwok
dyskusji	dyskusja	subst:sg:loc:f
nakreślono	nakreślić	imps:perf
plan	plan	subst:sg:acc:m3
działania	działanie	subst:sg:gen:n
na	na	prep:acc
najbliższe	bliski	adj:pl:acc:m3:sup
pięć	pięć	num:pl:acc:m3:rec
lat	rok	subst:pl:gen:m3
.	.	interp
Dokonano	dokonać	imps:perf
również	również	qub
zmian	zmiana	subst:pl:gen:f
w	w	prep:loc:nwok
statucie	statut	subst:sg:loc:m3
Towarzystwa	towarzystwo	subst:sg:gen:n
Muzycznego	muzyczny	adj:sg:gen:n:pos
imienia	imię	subst:sg:gen:n
Henryka	Henryk	subst:sg:gen:m1
Wieniawskiego	Wieniawski	subst:sg:gen:m1
.	.	interp
