Premier	premier	subst:sg:nom:m1
kontynuuje	kontynuować	fin:sg:ter:imperf
rozpoczętą	rozpocząć	ppas:sg:acc:f:perf:aff
w	w	prep:loc:nwok
ubiegłym	ubiegły	adj:sg:loc:m3:pos
tygodniu	tydzień	subst:sg:loc:m3
ofensywę	ofensywa	subst:sg:acc:f
dyplomatyczną	dyplomatyczny	adj:sg:acc:f:pos
,	,	interp
związaną	związany	adj:sg:acc:f:pos
ze	z	prep:inst:wok
stanowiskiem	stanowisko	subst:sg:inst:n
duńskim	duński	adj:sg:inst:n:pos
.	.	interp
Działania	działanie	subst:pl:nom:n
te	ten	adj:pl:nom:n:pos
,	,	interp
w	w	prep:acc:nwok
które	który	adj:pl:acc:n:pos
zaangażowane	zaangażować	ppas:sg:nom:n:perf:aff
jest	być	fin:sg:ter:imperf
całe	cały	adj:sg:nom:n:pos
kierownictwo	kierownictwo	subst:sg:nom:n
państwa	państwo	subst:sg:gen:n
,	,	interp
mają	mieć	fin:pl:ter:imperf
na	na	prep:loc
celu	cel	subst:sg:loc:m3
uzyskanie	uzyskać	ger:sg:acc:n:perf:aff
jak	jak	adv:pos
najkorzystniejszych	korzystny	adj:pl:gen:m3:sup
warunków	warunek	subst:pl:gen:m3
członkostwa	członkostwo	subst:sg:gen:n
Polski	Polska	subst:sg:gen:f
w	w	prep:loc:nwok
UE	UE	subst:sg:loc:f
.	.	interp
Jest	być	fin:sg:ter:imperf
to	to	pred
faktycznie	faktycznie	adv:pos
ostatni	ostatni	adj:sg:nom:m3:pos
tydzień	tydzień	subst:sg:nom:m3
przygotowań	przygotowanie	subst:pl:gen:n
przed	przed	prep:inst:nwok
grudniowym	grudniowy	adj:sg:inst:m3:pos
szczytem	szczyt	subst:sg:inst:m3
w	w	prep:loc:nwok
Kopenhadze	Kopenhaga	subst:sg:loc:f
,	,	interp
gdzie	gdzie	adv
ma	mieć	fin:sg:ter:imperf
nastąpić	nastąpić	inf:perf
zakończenie	zakończenie	subst:sg:nom:n
negocjacji	negocjacja	subst:pl:gen:f
z	z	prep:inst:nwok
krajami	kraj	subst:pl:inst:m3
kandydującymi	kandydować	pact:pl:inst:m3:imperf:aff
do	do	prep:gen
Unii	unia	subst:sg:gen:f
.	.	interp
