Z	z	prep:gen:nwok
powodów	powód	subst:pl:gen:m3
formalnych	formalny	adj:pl:gen:m3:pos
NSA	NSA	subst:sg:nom:m3
uchylił	uchylić	praet:sg:m3:perf
w	w	prep:acc:nwok
środę	środa	subst:sg:acc:f
decyzję	decyzja	subst:sg:acc:f
Urzędu	urząd	subst:sg:gen:m3
ds	do spraw	brev:pun
.	.	interp
Kombatantów	kombatant	subst:pl:gen:m1
o	o	prep:loc
odebraniu	odebrać	ger:sg:loc:n:perf:aff
praw	prawo	subst:pl:gen:n
kombatanckich	kombatancki	adj:pl:gen:n:pos
wdowie	wdowa	subst:sg:dat:f
po	po	prep:loc
komunistycznym	komunistyczny	adj:sg:loc:m1:pos
działaczu	działacz	subst:sg:loc:m1
Ignacym	Ignacy	subst:sg:loc:m1
Lodze	Loga	subst:sg:loc:m1
-	-	interp
Sowińskim	Sowiński	subst:sg:loc:m1
,	,	interp
którego	który	adj:sg:acc:m1:pos
Urząd	urząd	subst:sg:nom:m3
uznał	uznać	praet:sg:m3:perf
za	za	prep:acc
hitlerowskiego	hitlerowski	adj:sg:acc:m1:pos
kolaboranta	kolaborant	subst:sg:acc:m1
.	.	interp
Prawomocny	prawomocny	adj:sg:nom:m3:pos
wyrok	wyrok	subst:sg:nom:m3
NSA	NSA	subst:sg:gen:m3
oznacza	oznaczać	fin:sg:ter:imperf
,	,	interp
że	że	comp
Urząd	urząd	subst:sg:nom:m3
ponowi	ponowić	fin:sg:ter:perf
procedurę	procedura	subst:sg:acc:f
w	w	prep:loc:nwok
tej	ten	adj:sg:loc:f:pos
precedensowej	precedensowy	adj:sg:loc:f:pos
sprawie	sprawa	subst:sg:loc:f
.	.	interp
