W	w	prep:acc:nwok
piątek	piątek	subst:sg:acc:m3
policjanci	policjant	subst:pl:nom:m1
zatrzymali	zatrzymać	praet:pl:m1:perf
sprawcę	sprawca	subst:sg:acc:m1
kolizji	kolizja	subst:sg:gen:f
,	,	interp
który	który	adj:sg:nom:m1:pos
jechał	jechać	praet:sg:m1:imperf
samochodem	samochód	subst:sg:inst:m3
marki	marka	subst:sg:gen:f
Honda	Honda	subst:sg:nom:f
.	.	interp
po	po	prep:loc
sprawdzeniu	sprawdzić	ger:sg:loc:n:perf:aff
okazało	okazać	praet:sg:n:perf
się	się	qub
,	,	interp
że	że	comp
auto	auto	subst:sg:nom:n
zostało	zostać	praet:sg:n:perf
przed	przed	prep:inst:nwok
miesiącem	miesiąc	subst:sg:inst:m3
skradzione	skraść	ppas:sg:nom:n:perf:aff
we	w	prep:loc:wok
wsi	wieś	subst:sg:loc:f
Dubiny	Dubiny	subst:pl:nom:n
koło	koło	prep:gen
Hajnówki	Hajnówka	subst:sg:gen:f
.	.	interp
Kolejne	kolejny	adj:pl:nom:f:pos
czynności	czynność	subst:pl:nom:f
doprowadziły	doprowadzić	praet:pl:f:perf
do	do	prep:gen
zatrzymania	zatrzymać	ger:sg:gen:n:perf:aff
dwóch	dwa	num:pl:gen:m1:congr
sprawców	sprawca	subst:pl:gen:m1
kradzieży	kradzież	subst:sg:gen:f
(	(	interp
mieszkańcy	mieszkaniec	subst:pl:nom:m1
podhajnowskich	podhajnowski	adj:pl:gen:f:pos
wsi	wieś	subst:pl:gen:f
)	)	interp
oraz	oraz	conj
dwóch	dwa	num:pl:gen:m1:congr
paserów	paser	subst:pl:gen:m1
.	.	interp
Po	po	prep:loc
przeszukaniach	przeszukanie	subst:pl:loc:n
w	w	prep:loc:nwok
ich	on	ppron3:pl:gen:m1:ter:akc:npraep
mieszkaniach	mieszkanie	subst:pl:loc:n
i	i	conj
posesjach	posesja	subst:pl:loc:f
funkcjonariusze	funkcjonariusz	subst:pl:nom:m1
odzyskali	odzyskać	praet:pl:m1:perf
wiele	wiele	num:pl:acc:m3:rec
skradzionych	skraść	ppas:pl:gen:m3:perf:aff
przedmiotów	przedmiot	subst:pl:gen:m3
.	.	interp
