Taki	taki	adj:sg:acc:m3:pos
licznik	licznik	subst:sg:acc:m3
można	można	pred
uruchomić	uruchomić	inf:perf
za	za	prep:inst
pomocą	pomoc	subst:sg:inst:f
karty	karta	subst:sg:gen:f
magnetycznej	magnetyczny	adj:sg:gen:f:pos
,	,	interp
którą	który	adj:sg:acc:f:pos
trzeba	trzeba	pred
będzie	być	bedzie:sg:ter:imperf
kupić	kupić	inf:perf
.	.	interp
Zakłady	zakład	subst:pl:nom:m3
elektroenergetyczne	elektroenergetyczny	adj:pl:nom:m3:pos
bez	bez	prep:gen:nwok
entuzjazmu	entuzjazm	subst:sg:gen:m3
przyjmują	przyjmować	fin:pl:ter:imperf
rozwiązanie	rozwiązanie	subst:sg:acc:n
proponowane	proponować	ppas:sg:acc:n:imperf:aff
przez	przez	prep:acc:nwok
Ministerstwo	ministerstwo	subst:sg:acc:n
Gospodarki	gospodarka	subst:sg:gen:f
.	.	interp
Zdaniem	zdanie	subst:sg:inst:n
rzecznika	rzecznik	subst:sg:gen:m1
prasowego	prasowy	adj:sg:gen:m1:pos
Górnośląskiego	górnośląski	adj:sg:gen:m3:pos
Zakładu	zakład	subst:sg:gen:m3
Elektroenergetycznego	elektroenergetyczny	adj:sg:gen:m3:pos
SA	SA	subst:sg:nom:f
Łukasza	Łukasz	subst:sg:gen:m1
Zimocha	Zimoch	subst:sg:gen:m1
,	,	interp
propozycja	propozycja	subst:sg:nom:f
resortu	resort	subst:sg:gen:m3
jest	być	fin:sg:ter:imperf
atrakcyjna	atrakcyjny	adj:sg:nom:f:pos
,	,	interp
bo	bo	comp
w	w	prep:loc:nwok
kasie	kasa	subst:sg:loc:f
firmy	firma	subst:sg:gen:f
szybko	szybko	adv:pos
pojawi	pojawić	fin:sg:ter:perf
się	się	qub
gotówka	gotówka	subst:sg:nom:f
za	za	prep:acc
zużyty	zużyć	ppas:sg:acc:m3:perf:aff
prąd	prąd	subst:sg:acc:m3
.	.	interp
