Istotą	istota	subst:sg:inst:f
wynalazku	wynalazek	subst:sg:gen:m3
Polaka	Polak	subst:sg:gen:m1
,	,	interp
którego	który	adj:sg:gen:m3:pos
koszt	koszt	subst:sg:nom:m3
po	po	prep:loc
wprowadzenia	wprowadzić	ger:sg:loc:n:perf:aff
do	do	prep:gen
masowej	masowy	adj:sg:gen:f:pos
produkcji	produkcja	subst:sg:gen:f
ma	mieć	fin:sg:ter:imperf
nie	nie	qub
przekraczać	przekraczać	inf:imperf
50	50	num:pl:gen:m2:congr
dol	dolar	brev:pun
.	.	interp
,	,	interp
jest	być	fin:sg:ter:imperf
umieszczenie	umieścić	ger:sg:nom:n:perf:aff
w	w	prep:loc:nwok
deskorolkach	deskorolka	subst:pl:loc:f
specjalnych	specjalny	adj:pl:gen:m3:pos
mechanizmów	mechanizm	subst:pl:gen:m3
,	,	interp
które	który	adj:pl:nom:m3:pos
wraz	wraz	adv
ze	z	prep:inst:wok
zmianą	zmiana	subst:sg:inst:f
ułożenia	ułożenie	subst:sg:gen:n
ciała	ciało	subst:sg:gen:n
użytkownika	użytkownik	subst:sg:gen:m1
przyczyniają	przyczyniać	fin:pl:ter:imperf
się	się	qub
do	do	prep:gen
ich	on	ppron3:pl:gen:f:ter:akc:npraep
napędzania	napędzać	ger:sg:gen:n:imperf:aff
.	.	interp
Zagięta	zagiąć	ppas:sg:nom:f:perf:aff
na	na	prep:loc
przodzie	przód	subst:sg:loc:m3
deskorolka	deskorolka	subst:sg:nom:f
pozwala	pozwalać	fin:sg:ter:imperf
jeżdżącemu	jeździć	pact:sg:dat:m1:imperf:aff
-	-	interp
poprzez	poprzez	prep:acc:nwok
odpowiednie	odpowiedni	adj:sg:acc:n:pos
manewrowanie	manewrować	ger:sg:acc:n:imperf:aff
ułożeniem	ułożenie	subst:sg:inst:n
ciała	ciało	subst:sg:gen:n
i	i	conj
naciskanie	naciskać	ger:sg:acc:n:imperf:aff
nogami	noga	subst:pl:inst:f
to	to	conj
jej	on	ppron3:sg:gen:f:ter:akc:npraep
przodu	przód	subst:sg:gen:m3
to	to	conj
tyłu	tył	subst:sg:gen:m3
-	-	interp
na	na	prep:acc
gładkie	gładki	adj:sg:acc:n:pos
i	i	conj
szybkie	szybki	adj:sg:acc:n:pos
pokonywanie	pokonywać	ger:sg:acc:n:imperf:aff
przestrzeni	przestrzeń	subst:sg:gen:f
.	.	interp
