Nowotwory	nowotwór	subst:pl:nom:m3
przerzutowe	przerzutowy	adj:pl:nom:m3:pos
do	do	prep:gen
kości	kość	subst:pl:gen:f
nierzadko	nierzadko	adv:pos
są	być	fin:pl:ter:imperf
powodem	powód	subst:sg:inst:m3
pierwszych	pierwszy	adj:pl:gen:m3:pos
objawów	objaw	subst:pl:gen:m3
dotychczas	dotychczas	adv
nie	nie	qub
ujawniajacego	ujawniać	pact:sg:gen:m3:imperf:aff
się	się	qub
nowotworu	nowotwór	subst:sg:gen:m3
.	.	interp
W	w	prep:loc:nwok
zasadzie	zasada	subst:sg:loc:f
każdy	każdy	adj:sg:nom:m3:pos
nowotwór	nowotwór	subst:sg:nom:m3
złosliwy	złośliwy	adj:sg:nom:m3:pos
może	móc	fin:sg:ter:imperf
przerzutować	przerzutować	inf:imperf
do	do	prep:gen
kości	kość	subst:pl:gen:f
,	,	interp
najczęściej	często	adv:sup
są	być	fin:pl:ter:imperf
to	to	pred
ERROR :		:interp
rak	rak	subst:sg:nom:m2
sutka	sutek	subst:sg:gen:m3
rak	rak	subst:sg:nom:m2
stercza	stercz	subst:sg:gen:m3
rak	rak	subst:sg:nom:m2
nerki	nerka	subst:sg:gen:f
rak	rak	subst:sg:nom:m2
tarczycy	tarczyca	subst:sg:gen:f
rak	rak	subst:sg:nom:m2
żołądka	żołądek	subst:sg:gen:m3
rak	rak	subst:sg:nom:m2
drobnokomórkowy	drobnokomórkowy	adj:sg:nom:m2:pos
płuca	płuco	subst:sg:gen:n
nerwiak	nerwiak	subst:sg:nom:m2
płodowy	płodowy	adj:sg:nom:m2:pos
(	(	interp
u	u	prep:gen
dzieci	dziecko	subst:pl:gen:n
)	)	interp
.	.	interp
