Decyzja	decyzja	subst:sg:nom:f
w	w	prep:loc:nwok
sprawie	sprawa	subst:sg:loc:f
inspekcji	inspekcja	subst:sg:gen:f
ONZ	ONZ	subst:sg:gen:f
,	,	interp
mającej	mieć	pact:sg:gen:f:imperf:aff
zdecydować	zdecydować	inf:perf
o	o	prep:loc
zniszczeniu	zniszczyć	ger:sg:loc:n:perf:aff
irackich	iracki	adj:pl:gen:m3:pos
arsenałów	arsenał	subst:pl:gen:m3
broni	broń	subst:sg:gen:f
masowej	masowy	adj:sg:gen:f:pos
zagłady	zagłada	subst:sg:gen:f
,	,	interp
zapadła	zapaść	praet:sg:f:perf
po	po	prep:loc
wojnie	wojna	subst:sg:loc:f
w	w	prep:loc:nwok
Zatoce	Zatoka	subst:sg:loc:f
Perskiej	Perski	adj:sg:loc:f:pos
.	.	interp
Irak	Irak	subst:sg:nom:m3
sabotował	sabotować	praet:sg:m3:imperf
jednak	jednak	conj
działania	działanie	subst:pl:acc:n
inspektorów	inspektor	subst:pl:gen:m1
i	i	conj
po	po	prep:loc
odmowie	odmowa	subst:sg:loc:f
wpuszczenia	wpuścić	ger:sg:gen:n:perf:aff
misji	misja	subst:pl:gen:f
ONZ-owskich	ONZ-owski	adj:pl:gen:f:pos
do	do	prep:gen
wyznaczonych	wyznaczyć	ppas:pl:gen:m3:perf:aff
obiektów	obiekt	subst:pl:gen:m3
-	-	interp
w	w	prep:loc:nwok
tym	to	subst:sg:loc:n
kilku	kilka	num:pl:gen:m3:congr
pałaców	pałac	subst:pl:gen:m3
Saddama	Saddam	subst:sg:gen:m1
Husajna	Husajn	subst:sg:gen:m1
-	-	interp
Rada	rada	subst:sg:nom:f
Bezpieczeństwa	bezpieczeństwo	subst:sg:gen:n
postanowiła	postanowić	praet:sg:f:perf
odwołać	odwołać	inf:perf
inspektorów	inspektor	subst:pl:acc:m1
.	.	interp
