Tymczasem	tymczasem	adv
sytuacja	sytuacja	subst:sg:nom:f
międzynarodowa	międzynarodowy	adj:sg:nom:f:pos
zaczęła	zacząć	praet:sg:f:perf
się	się	qub
zmieniać	zmieniać	inf:imperf
-	-	interp
po	po	prep:loc
kryzysie	kryzys	subst:sg:loc:m3
kubańskim	kubański	adj:sg:loc:m3:pos
,	,	interp
który	który	adj:sg:nom:m3:pos
zakończył	zakończyć	praet:sg:m3:perf
się	się	qub
porażką	porażka	subst:sg:inst:f
ZSRR	ZSRR	subst:sg:gen:m3
,	,	interp
nastąpiło	nastąpić	praet:sg:n:perf
w	w	prep:loc:nwok
Europie	Europa	subst:sg:loc:f
pewne	pewien	adj:sg:nom:n:pos
odprężenie	odprężenie	subst:sg:nom:n
,	,	interp
które	który	adj:sg:nom:n:pos
doprowadziło	doprowadzić	praet:sg:n:perf
do	do	prep:gen
podpisania	podpisać	ger:sg:gen:n:perf:aff
traktatu	traktat	subst:sg:gen:m3
o	o	prep:loc
częściowym	częściowy	adj:sg:loc:m3:pos
zakazie	zakaz	subst:sg:loc:m3
prób	próba	subst:pl:gen:f
jądrowych	jądrowy	adj:pl:gen:f:pos
(	(	interp
Moskwa	Moskwa	subst:sg:nom:f
,	,	interp
1963	1963	adj:sg:nom:m3:pos
r	rok	brev:pun
.	.	interp
)	)	interp
.	.	interp
Rosły	rosnąć	praet:pl:n:imperf
za	za	prep:acc
to	to	subst:sg:acc:n
napięcia	napięcie	subst:pl:nom:n
w	w	prep:loc:nwok
Azji	Azja	subst:sg:loc:f
tak	tak	conj
na	na	prep:loc
granicy	granica	subst:sg:loc:f
radziecko	radziecki	adja
-	-	interp
chińskiej	chiński	adj:sg:loc:f:pos
,	,	interp
jak	jak	conj
i	i	conj
w	w	prep:loc:nwok
Wietnamie	Wietnam	subst:sg:loc:m3
.	.	interp
