Prezes	prezes	subst:sg:nom:m1
Radia	radio	subst:sg:gen:n
dla	dla	prep:gen
Ciebie	ty	ppron12:sg:gen:m1:sec:akc
zwrócił	zwrócić	praet:sg:m1:perf
się	się	qub
do	do	prep:gen
Rzecznika	rzecznik	subst:sg:gen:m1
Praw	prawo	subst:pl:gen:n
Obywatelskich	obywatelski	adj:pl:gen:n:pos
o	o	prep:acc
wyjaśnienie	wyjaśnienie	subst:sg:acc:n
podstaw	podstawa	subst:pl:gen:f
prawnych	prawny	adj:pl:gen:f:pos
,	,	interp
na	na	prep:loc
jakich	jaki	adj:pl:loc:f:pos
oparł	oprzeć	praet:sg:m1:perf
się	się	qub
Sellin	Sellin	subst:sg:nom:m1
żądając	żądać	pcon:imperf
odpowiedzi	odpowiedź	subst:sg:gen:f
na	na	prep:acc
temat	temat	subst:sg:acc:m3
przynależności	przynależność	subst:sg:gen:f
do	do	prep:gen
partii	partia	subst:sg:gen:f
.	.	interp
RPO	RPO	subst:sg:nom:m1
podjął	podjąć	praet:sg:m1:perf
się	się	qub
zbadania	zbadać	ger:sg:gen:n:perf:aff
sprawy	sprawa	subst:sg:gen:f
.	.	interp
Wyszedł	wyjść	praet:sg:m1:perf
z	z	prep:gen:nwok
założenia	założenie	subst:sg:gen:n
,	,	interp
że	że	comp
wskazane	wskazać	ppas:pl:nom:m3:perf:aff
przez	przez	prep:acc:nwok
Sellina	Sellin	subst:sg:acc:m1
przepisy	przepis	subst:pl:nom:m3
ustawy	ustawa	subst:sg:gen:f
o	o	prep:loc
radiofonii	radiofonia	subst:sg:loc:f
i	i	conj
telewizji	telewizja	subst:sg:loc:f
-	-	interp
mające	mieć	pact:pl:nom:m3:imperf:aff
stanowić	stanowić	inf:imperf
podstawę	podstawa	subst:sg:acc:f
do	do	prep:gen
wystąpienia	wystąpić	ger:sg:gen:n:perf:aff
o	o	prep:acc
informacje	informacja	subst:pl:acc:f
na	na	prep:acc
temat	temat	subst:sg:acc:m3
przynależności	przynależność	subst:sg:gen:f
partyjnej	partyjny	adj:sg:gen:f:pos
członków	członek	subst:pl:gen:m1
zarządów	zarząd	subst:pl:gen:m3
publicznych	publiczny	adj:pl:gen:n:pos
mediów	medium	subst:pl:gen:n
-	-	interp
takiego	taki	adj:sg:gen:n:pos
prawa	prawo	subst:sg:gen:n
nie	nie	qub
dają	dawać	fin:pl:ter:imperf
.	.	interp
