Wszyscy	wszystek	adj:pl:nom:m1:pos
chorzy	chory	subst:pl:nom:m1
pili	pić	praet:pl:m1:imperf
odtłuszczone	odtłuścić	ppas:sg:acc:n:perf:aff
mleko	mleko	subst:sg:acc:n
,	,	interp
wyprodukowane	wyprodukować	ppas:sg:acc:n:perf:aff
przez	przez	prep:acc:nwok
największą	duży	adj:sg:acc:f:sup
mleczarnię	mleczarnia	subst:sg:acc:f
rejonu	rejon	subst:sg:gen:m3
Kansai	Kansai	subst:sg:nom:m3
.	.	interp
Jakkolwiek	jakkolwiek	comp
badania	badanie	subst:pl:nom:n
laboratoryjne	laboratoryjny	adj:pl:nom:n:pos
są	być	fin:pl:ter:imperf
jeszcze	jeszcze	qub
w	w	prep:loc:nwok
toku	tok	subst:sg:loc:m3
,	,	interp
w	w	prep:acc:nwok
piątek	piątek	subst:sg:acc:m3
rano	rano	adv:pos
ze	z	prep:gen:wok
sklepów	sklep	subst:pl:gen:m3
w	w	prep:loc:nwok
Osace	Osaka	subst:sg:loc:f
wycofano	wycofać	imps:perf
ze	z	prep:gen:wok
sprzedaży	sprzedaż	subst:sg:gen:f
produkty	produkt	subst:pl:acc:m3
zakładu	zakład	subst:sg:gen:m3
,	,	interp
w	w	prep:loc:nwok
tym	to	subst:sg:loc:n
przede	przed	prep:inst:wok
wszystkim	wszystko	subst:sg:inst:n
ponad	ponad	qub
300	300	num:pl:acc:m3:rec
tysięcy	tysiąc	subst:pl:gen:m3
opakowań	opakowanie	subst:pl:gen:n
mleka	mleko	subst:sg:gen:n
.	.	interp
Mleczarnia	mleczarnia	subst:sg:nom:f
zapewnia	zapewniać	fin:sg:ter:imperf
,	,	interp
że	że	comp
w	w	prep:loc:nwok
zakwestionowanym	zakwestionować	ppas:sg:loc:n:perf:aff
mleku	mleko	subst:sg:loc:n
nie	nie	qub
wykryto	wykryć	imps:perf
jakichkolwiek	jakikolwiek	adj:pl:gen:f:pos
bakterii	bakteria	subst:pl:gen:f
,	,	interp
które	który	adj:pl:nom:f:pos
mogły	móc	praet:pl:f:imperf
by	by	qub
powodować	powodować	inf:imperf
zatrucie	zatrucie	subst:sg:acc:n
.	.	interp
