Ważka	ważki	adj:sg:nom:f:pos
,	,	interp
ze	z	prep:gen:wok
względu	wzgląd	subst:sg:gen:m3
na	na	prep:acc
kształt	kształt	subst:sg:acc:m3
całej	cały	adj:sg:gen:f:pos
ustawy	ustawa	subst:sg:gen:f
i	i	conj
jej	on	ppron3:sg:gen:f:ter:akc:npraep
wewnętrzną	wewnętrzny	adj:sg:acc:f:pos
spójność	spójność	subst:sg:acc:f
,	,	interp
była	być	praet:sg:f:imperf
definicja	definicja	subst:sg:nom:f
pojęcia	pojęcie	subst:sg:gen:n
doświadczenia	doświadczenie	subst:sg:gen:n
na	na	prep:loc
zwierzęciu	zwierzę	subst:sg:loc:n
.	.	interp
Sejm	sejm	subst:sg:nom:m3
dokonał	dokonać	praet:sg:m3:perf
daleko	daleko	adv:pos
idącej	iść	pact:sg:gen:f:imperf:aff
zmiany	zmiana	subst:sg:gen:f
w	w	prep:loc:nwok
tym	ten	adj:sg:loc:m3:pos
zakresie	zakres	subst:sg:loc:m3
,	,	interp
co	co	subst:sg:nom:n
pociąga	pociągać	fin:sg:ter:imperf
za	za	prep:inst
sobą	siebie	siebie:inst
konieczność	konieczność	subst:sg:acc:f
głębokiej	głęboki	adj:sg:gen:f:pos
analizy	analiza	subst:sg:gen:f
dużej	duży	adj:sg:gen:f:pos
części	część	subst:sg:gen:f
obowiązujących	obowiązujący	adj:pl:gen:f:pos
,	,	interp
ustawowych	ustawowy	adj:pl:gen:f:pos
regulacji	regulacja	subst:pl:gen:f
oraz	oraz	conj
konieczność	konieczność	subst:sg:acc:f
daleko	daleko	adv:pos
idących	iść	pact:pl:gen:f:imperf:aff
zmian	zmiana	subst:pl:gen:f
merytorycznych	merytoryczny	adj:pl:gen:f:pos
,	,	interp
szczególnie	szczególnie	qub
w	w	prep:loc:nwok
kontekście	kontekst	subst:sg:loc:m3
wzajemnych	wzajemny	adj:pl:gen:f:pos
relacji	relacja	subst:pl:gen:f
doświadczeń	doświadczenie	subst:pl:gen:n
i	i	conj
testów	test	subst:pl:gen:m3
na	na	prep:loc
zwierzętach	zwierzę	subst:pl:loc:n
.	.	interp
