Zdaniem	zdanie	subst:sg:inst:n
wiceprezesa	wiceprezes	subst:sg:gen:m1
szczecińskiego	szczeciński	adj:sg:gen:m3:pos
OZPN	OZPN	subst:sg:gen:m3
Jana	Jan	subst:sg:gen:m1
Wilka	Wilk	subst:sg:gen:m1
,	,	interp
ok	około	brev:pun
.	.	interp
30	30	num:pl:nom:m1:rec
piłkarzy	piłkarz	subst:pl:gen:m1
z	z	prep:gen:nwok
przygranicznych	przygraniczny	adj:pl:gen:m3:pos
polskich	polski	adj:pl:gen:m3:pos
klubów	klub	subst:pl:gen:m3
ligi	liga	subst:sg:gen:f
okręgowej	okręgowy	adj:sg:gen:f:pos
i	i	conj
klasy	klasa	subst:sg:gen:f
A	A	subst:sg:nom:n
nielegalnie	nielegalnie	adv:pos
reprezentuje	reprezentować	fin:sg:ter:imperf
barwy	barwa	subst:pl:acc:f
zespołów	zespół	subst:pl:gen:m3
niemieckich	niemiecki	adj:pl:gen:m3:pos
w	w	prep:loc:nwok
rozgrywkach	rozgrywka	subst:pl:loc:f
o	o	prep:acc
mistrzostwo	mistrzostwo	subst:sg:acc:n
niższych	niski	adj:pl:gen:f:com
,	,	interp
regionalnych	regionalny	adj:pl:gen:f:pos
lig	liga	subst:pl:gen:f
niemieckich	niemiecki	adj:pl:gen:f:pos
.	.	interp
Grają	grać	fin:pl:ter:imperf
,	,	interp
nie	nie	qub
mając	mieć	pcon:imperf
wymaganych	wymagać	ppas:pl:gen:m3:imperf:aff
polskich	polski	adj:pl:gen:m3:pos
certyfikatów	certyfikat	subst:pl:gen:m3
,	,	interp
stwierdził	stwierdzić	praet:sg:m1:perf
J	J	brev:pun
.	.	interp
Wilk	Wilk	subst:sg:nom:m1
w	w	prep:loc:nwok
rozmowie	rozmowa	subst:sg:loc:f
z	z	prep:inst:nwok
dziennikarzem	dziennikarz	subst:sg:inst:m1
.	.	interp
