Suche	suchy	adj:pl:nom:f:pos
trawy	trawa	subst:pl:nom:f
łamią	łamać	fin:pl:ter:imperf
się	się	qub
pod	pod	prep:inst:nwok
racicami	racica	subst:pl:inst:f
twoich	twój	adj:pl:gen:m2:pos
baranów	baran	subst:pl:gen:m2
,	,	interp
owiec	owca	subst:pl:gen:f
i	i	conj
kóz	koza	subst:pl:gen:f
.	.	interp
Zamiera	zamierać	fin:sg:ter:imperf
łono	łono	subst:sg:nom:n
ziemi	ziemia	subst:sg:gen:f
.	.	interp
Wyschły	wyschnąć	praet:pl:n:perf
źródła	źródło	subst:pl:nom:n
.	.	interp
O	o	interj
,	,	interp
ojczulku	ojczulek	subst:sg:voc:m1
!	!	interp
wielkie	wielki	adj:sg:nom:n:pos
nieszczęście	nieszczęście	subst:sg:nom:n
,	,	interp
zagłada	zagłada	subst:sg:nom:f
straszliwa	straszliwy	adj:sg:nom:f:pos
zagląda	zaglądać	fin:sg:ter:imperf
nam	my	ppron12:pl:dat:m1:pri
w	w	prep:acc:nwok
oczy	oko	subst:pl:acc:n
.	.	interp
Słyszysz	słyszeć	fin:sg:sec:imperf
żałosne	żałosny	adj:pl:acc:f:pos
skargi	skarga	subst:pl:acc:f
głodnych	głodny	adj:pl:gen:n:pos
i	i	conj
złaknionych	złakniony	adj:pl:gen:n:pos
zwierząt	zwierzę	subst:pl:gen:n
?	?	interp
Prawie	prawie	qub
wszystkie	wszystek	adj:pl:acc:n:pos
znam	znać	fin:sg:pri:imperf
na	na	prep:acc
pamięć	pamięć	subst:sg:acc:f
,	,	interp
od	od	prep:gen:nwok
kiedy	kiedy	adv
moja	mój	adj:sg:nom:f:pos
pamięć	pamięć	subst:sg:nom:f
sięga	sięgać	fin:sg:ter:imperf
.	.	interp
