Procedura	procedura	subst:sg:nom:f
przyjęta	przyjąć	ppas:sg:nom:f:perf:aff
w	w	prep:loc:nwok
konstytucji	konstytucja	subst:sg:loc:f
(	(	interp
art	artykuł	brev:pun
.	.	interp
45	45	adj:sg:nom:m3:pos
i	i	conj
46	46	adj:sg:nom:m3:pos
)	)	interp
odznacza	odznaczać	fin:sg:ter:imperf
się	się	qub
dwiema	dwa	num:pl:inst:f:congr
charakterystycznymi	charakterystyczny	adj:pl:inst:f:pos
cechami	cecha	subst:pl:inst:f
ERROR :		:interp
po	po	prep:acc
pierwsze	pierwszy	adj:sg:acc:n:pos
–	–	interp
wzmocnieniem	wzmocnienie	subst:sg:inst:n
roli	rola	subst:sg:gen:f
premiera	premier	subst:sg:gen:m1
,	,	interp
który	który	adj:sg:nom:m1:pos
osobiście	osobiście	adv:pos
ubiega	ubiegać	fin:sg:ter:imperf
się	się	qub
o	o	prep:acc
inwestyturę	inwestytura	subst:sg:acc:f
przyznawaną	przyznawać	ppas:sg:acc:f:imperf:aff
mu	on	ppron3:sg:dat:m1:ter:nakc:npraep
personalnie	personalnie	adv:pos
oraz	oraz	conj
dobiera	dobierać	fin:sg:ter:imperf
sobie	siebie	siebie:dat
współpracowników	współpracownik	subst:pl:acc:m1
;	;	interp
po	po	prep:acc
drugie	drugi	adj:sg:acc:n:pos
–	–	interp
wyrażaniem	wyrażać	ger:sg:inst:n:imperf:aff
przez	przez	prep:acc:nwok
Zgromadzenie	zgromadzenie	subst:sg:acc:n
Narodowe	narodowy	adj:sg:acc:n:pos
zaufania	zaufanie	subst:sg:gen:n
–	–	interp
absolutną	absolutny	adj:sg:inst:f:pos
większością	większość	subst:sg:inst:f
głosów	głos	subst:pl:gen:m3
–	–	interp
nie	nie	conj
tylko	tylko	conj
kandydatowi	kandydat	subst:sg:dat:m1
na	na	prep:acc
premiera	premier	subst:sg:acc:m1
,	,	interp
ale	ale	conj
także	także	conj
i	i	conj
programowi	program	subst:sg:dat:m3
działania	działanie	subst:sg:gen:n
rządu	rząd	subst:sg:gen:m3
.	.	interp
