Burmistrz	burmistrz	subst:sg:nom:m1
brazylijskiego	brazylijski	adj:sg:gen:n:pos
miasta	miasto	subst:sg:gen:n
Bocaiura	Bocaiura	subst:sg:nom:f
do	do	subst:sg:nom:f
Sul	Sul	subst:sg:nom:f
w	w	prep:loc:nwok
stanie	stan	subst:sg:loc:m3
Parana	Parana	subst:sg:nom:f
,	,	interp
ogłosił	ogłosić	praet:sg:m1:perf
bezpłatne	bezpłatny	adj:sg:acc:n:pos
rozdawanie	rozdawać	ger:sg:acc:n:imperf:aff
mężczyznom	mężczyzna	subst:pl:dat:m1
viagry	viagra	subst:sg:gen:f
.	.	interp
Ma	mieć	fin:sg:ter:imperf
to	to	subst:sg:nom:n
na	na	prep:loc
celu	cel	subst:sg:loc:m3
podniesienie	podnieść	ger:sg:acc:n:perf:aff
przyrostu	przyrost	subst:sg:gen:m3
naturalnego	naturalny	adj:sg:gen:m3:pos
,	,	interp
a	a	conj
dzięki	dzięki	prep:dat
temu	to	subst:sg:dat:n
zwiększenie	zwiększyć	ger:sg:acc:n:perf:aff
federalnej	federalny	adj:sg:gen:f:pos
pomocy	pomoc	subst:sg:gen:f
finansowej	finansowy	adj:sg:gen:f:pos
dla	dla	prep:gen
miasta	miasto	subst:sg:gen:n
.	.	interp
W	w	prep:loc:nwok
ubiegłym	ubiegły	adj:sg:loc:m3:pos
roku	rok	subst:sg:loc:m3
wprowadził	wprowadzić	praet:sg:m1:perf
on	on	ppron3:sg:nom:m1:ter:akc:npraep
zakaz	zakaz	subst:sg:acc:m3
sprzedawania	sprzedawać	ger:sg:gen:n:imperf:aff
prezerwatyw	prezerwatywa	subst:pl:gen:f
,	,	interp
ale	ale	conj
musiał	musieć	praet:sg:m1:imperf
się	się	qub
z	z	prep:gen:nwok
tego	to	subst:sg:gen:n
wycofać	wycofać	inf:perf
,	,	interp
gdyż	gdyż	comp
władze	władza	subst:pl:nom:f
zwierzchnie	zwierzchni	adj:pl:nom:f:pos
uznały	uznać	praet:pl:f:perf
to	ten	adj:sg:acc:n:pos
posunięcie	posunięcie	subst:sg:acc:n
za	za	prep:acc
sprzeczne	sprzeczny	adj:sg:acc:n:pos
z	z	prep:inst:nwok
konstytucją	konstytucja	subst:sg:inst:f
.	.	interp
