Minister	minister	subst:sg:nom:m1
rolnictwa	rolnictwo	subst:sg:gen:n
i	i	conj
gospodarki	gospodarka	subst:sg:gen:f
żywnościowej	żywnościowy	adj:sg:gen:f:pos
likwiduje	likwidować	fin:sg:ter:imperf
od	od	prep:gen:nwok
1	1	adj:sg:gen:m3:pos
lutego	luty	subst:sg:gen:m3
placówkę	placówka	subst:sg:acc:f
granicznej	graniczny	adj:sg:gen:f:pos
kontroli	kontrola	subst:sg:gen:f
weterynaryjnej	weterynaryjny	adj:sg:gen:f:pos
w	w	prep:loc:nwok
porcie	port	subst:sg:loc:m3
w	w	prep:loc:nwok
Kołobrzegu	Kołobrzeg	subst:sg:loc:m3
.	.	interp
Sprzeciwiają	sprzeciwiać	fin:pl:ter:imperf
się	się	qub
temu	to	subst:sg:dat:n
importerzy	importer	subst:pl:nom:m1
ryb	ryba	subst:pl:gen:f
,	,	interp
przedstawiciele	przedstawiciel	subst:pl:nom:m1
największych	duży	adj:pl:gen:m3:sup
w	w	prep:loc:nwok
kraju	kraj	subst:sg:loc:m3
zakładów	zakład	subst:pl:gen:m3
przetwórczych	przetwórczy	adj:pl:gen:m3:pos
i	i	conj
właściciel	właściciel	subst:sg:nom:m1
portu	port	subst:sg:gen:m3
-	-	interp
Polska	polski	adj:sg:nom:f:pos
Żegluga	żegluga	subst:sg:nom:f
Bałtycka	bałtycki	adj:sg:nom:f:pos
.	.	interp
Przez	przez	prep:acc:nwok
port	port	subst:sg:acc:m3
w	w	prep:loc:nwok
Kołobrzegu	Kołobrzeg	subst:sg:loc:m3
przechodzi	przechodzić	fin:sg:ter:imperf
rocznie	rocznie	adv:pos
około	około	qub
30	30	num:pl:nom:m3:rec
tys	tysiąc	brev:pun
.	.	interp
ton	tona	subst:pl:gen:f
ryb	ryba	subst:pl:gen:f
mrożonych	mrozić	ppas:pl:gen:f:imperf:aff
.	.	interp
