Obecnie	obecnie	adv:pos
Browar	browar	subst:sg:nom:m3
Dojlidy	Dojlidy	subst:pl:nom:n
posiada	posiadać	fin:sg:ter:imperf
już	już	qub
24	24	num:pl:acc:n:congr
takie	taki	adj:pl:acc:n:pos
urządzenia	urządzenie	subst:pl:acc:n
.	.	interp
Docelowo	docelowo	adv:pos
ma	mieć	fin:sg:ter:imperf
ich	on	ppron3:pl:gen:n:ter:akc:npraep
być	być	inf:imperf
50	50	num:pl:nom:n:rec
.	.	interp
Każdy	każdy	adj:sg:nom:m3:pos
z	z	prep:gen:nwok
tankofermentatorów	tankofermentator	subst:pl:nom:m3
jest	być	fin:sg:ter:imperf
przystosowany	przystosować	ppas:sg:nom:m3:perf:aff
do	do	prep:gen
przechowywania	przechowywać	ger:sg:gen:n:imperf:aff
2200	2200	num:pl:gen:m3:congr
hektolitrów	hektolitr	subst:pl:gen:m3
piwa	piwo	subst:sg:gen:n
,	,	interp
co	co	subst:sg:nom:n
odpowiada	odpowiadać	fin:sg:ter:imperf
500	500	num:pl:dat:m3:congr
tys	tysiąc	brev:pun
.	.	interp
sztuk	sztuka	subst:pl:gen:f
butelek	butelka	subst:pl:gen:f
.	.	interp
W	w	prep:loc:nwok
bieżącym	bieżący	adj:sg:loc:m3:pos
roku	rok	subst:sg:loc:m3
Dojlidy	Dojlidy	subst:pl:nom:n
zamierzają	zamierzać	fin:pl:ter:imperf
wzmocnić	wzmocnić	inf:perf
swoją	swój	adj:sg:acc:f:pos
pozycję	pozycja	subst:sg:acc:f
na	na	prep:loc
rynku	rynek	subst:sg:loc:m3
w	w	prep:loc:nwok
Polsce	Polska	subst:sg:loc:f
.	.	interp
W	w	prep:loc:nwok
tym	ten	adj:sg:loc:m3:pos
celu	cel	subst:sg:loc:m3
zwiększają	zwiększać	fin:pl:ter:imperf
nakłady	nakład	subst:pl:acc:m3
na	na	prep:acc
inwestycje	inwestycja	subst:pl:acc:f
.	.	interp
