Po	po	prep:loc
przeprowadzonym	przeprowadzić	ppas:sg:loc:m3:perf:aff
eksperymencie	eksperyment	subst:sg:loc:m3
częściowe	częściowy	adj:sg:acc:n:pos
potwierdzenie	potwierdzenie	subst:sg:acc:n
znajduje	znajdować	fin:sg:ter:imperf
druga	drugi	adj:sg:nom:f:pos
z	z	prep:gen:nwok
postawionych	postawić	ppas:pl:gen:f:perf:aff
hipotez	hipoteza	subst:pl:gen:f
badawczych	badawczy	adj:pl:gen:f:pos
dotycząca	dotyczyć	pact:sg:nom:f:imperf:aff
braku	brak	subst:sg:gen:m3
różnic	różnica	subst:pl:gen:f
w	w	prep:loc:nwok
ogólnej	ogólny	adj:sg:loc:f:pos
sprawności	sprawność	subst:sg:loc:f
fizycznej	fizyczny	adj:sg:loc:f:pos
pomiędzy	pomiędzy	prep:inst
grupami	grupa	subst:pl:inst:f
eksperymentalną	eksperymentalny	adj:sg:inst:f:pos
a	a	conj
kontrolną	kontrolny	adj:sg:inst:f:pos
.	.	interp
Nie	nie	qub
potwierdzają	potwierdzać	fin:pl:ter:imperf
jej	on	ppron3:sg:gen:f:ter:akc:npraep
zwłaszcza	zwłaszcza	qub
pomiary	pomiar	subst:pl:nom:m3
prób	próba	subst:pl:gen:f
siły	siła	subst:sg:gen:f
oraz	oraz	conj
częściowo	częściowo	adv:pos
mocy	moc	subst:sg:gen:f
i	i	conj
zwinności	zwinność	subst:sg:gen:f
,	,	interp
natomiast	natomiast	conj
znacząco	znacząco	adv:pos
potwierdzają	potwierdzać	fin:pl:ter:imperf
próby	próba	subst:pl:nom:f
szybkości	szybkość	subst:sg:gen:f
i	i	conj
wytrzymałości	wytrzymałość	subst:sg:gen:f
.	.	interp
