W	w	prep:loc:nwok
nowym	nowy	adj:sg:loc:m3:pos
białoruskim	białoruski	adj:sg:loc:m3:pos
parlamencie	parlament	subst:sg:loc:m3
znalazło	znaleźć	praet:sg:n:perf
się	się	qub
kilka	kilka	num:pl:nom:f:rec
osób	osoba	subst:pl:gen:f
z	z	prep:gen:nwok
,	,	interp
jak	jak	adv:pos
określają	określać	fin:pl:ter:imperf
to	to	subst:sg:acc:n
władze	władza	subst:pl:nom:f
,	,	interp
"	"	interp
konstruktywnej	konstruktywny	adj:sg:gen:f:pos
opozycji	opozycja	subst:sg:gen:f
"	"	interp
.	.	interp
Po	po	prep:loc
niedzielnej	niedzielny	adj:sg:loc:f:pos
drugiej	drugi	adj:sg:loc:f:pos
turze	tura	subst:sg:loc:f
wyborów	wybory	subst:pl:gen:n
Izba	izba	subst:sg:nom:f
Reprezentantów	reprezentant	subst:pl:gen:m1
będzie	być	bedzie:sg:ter:imperf
liczyła	liczyć	praet:sg:f:imperf
97	97	num:pl:acc:m1:rec
deputowanych	deputowany	subst:pl:gen:m1
.	.	interp
13	13	num:pl:gen:m1:congr
nie	nie	qub
udało	udać	praet:sg:n:perf
się	się	qub
wybrać	wybrać	inf:perf
ze	z	prep:gen:wok
względu	wzgląd	subst:sg:gen:m3
na	na	prep:acc
zbyt	zbyt	qub
niską	niski	adj:sg:acc:f:pos
frekwencję	frekwencja	subst:sg:acc:f
.	.	interp
