Był	być	praet:sg:m3:imperf
to	to	pred
dobry	dobry	adj:sg:nom:m3:pos
gest	gest	subst:sg:nom:m3
ze	z	prep:gen:wok
strony	strona	subst:sg:gen:f
niemieckiego	niemiecki	adj:sg:gen:m1:pos
właściciela	właściciel	subst:sg:gen:m1
,	,	interp
gdyż	gdyż	comp
zgodnie	zgodnie	adv:pos
z	z	prep:inst:nwok
przepisami	przepis	subst:pl:inst:m3
rolnicy	rolnik	subst:pl:nom:m1
powinni	powinien	winien:pl:m1:imperf
domagać	domagać	inf:imperf
się	się	qub
zaległych	zaległy	adj:pl:gen:m3:pos
pieniędzy	pieniądz	subst:pl:gen:m3
od	od	prep:gen:nwok
syndyka	syndyk	subst:sg:gen:m1
upadłej	upadły	adj:sg:gen:f:pos
cukrowni	cukrownia	subst:sg:gen:f
w	w	prep:loc:nwok
Przeworsku	Przeworsk	subst:sg:loc:m3
.	.	interp
Pieniędzy	pieniądz	subst:pl:gen:m3
tych	ten	adj:pl:gen:m3:pos
nie	nie	qub
wypłacił	wypłacić	praet:sg:m1:perf
bowiem	bowiem	comp
rolnikom	rolnik	subst:pl:dat:m1
poprzedni	poprzedni	adj:sg:nom:m1:pos
właściciel	właściciel	subst:sg:nom:m1
spółki	spółka	subst:sg:gen:f
.	.	interp
Łącznie	łącznie	adv:pos
miało	mieć	praet:sg:n:imperf
to	to	pred
być	być	inf:imperf
ok	około	brev:pun
.	.	interp
700	700	num:pl:nom:m3:rec
tys	tysiąc	brev:pun
.	.	interp
złotych	złoty	subst:pl:gen:m2
.	.	interp
