Skoro	skoro	comp
mowa	mowa	subst:sg:nom:f
o	o	prep:loc
dodatku	dodatek	subst:sg:loc:m3
za	za	prep:acc
odznaczenie	odznaczenie	subst:sg:acc:n
,	,	interp
to	to	conj
trudno	trudno	adv:pos
zrozumieć	zrozumieć	inf:perf
dlaczego	dlaczego	adv
nie	nie	qub
przewiduje	przewidywać	fin:sg:ter:imperf
go	on	ppron3:sg:gen:m3:ter:nakc:npraep
ustawa	ustawa	subst:sg:nom:f
wypadkowa	wypadkowy	adj:sg:nom:f:pos
.	.	interp
Wydaje	wydawać	fin:sg:ter:imperf
się	się	qub
,	,	interp
że	że	comp
ludzie	człowiek	subst:pl:nom:m1
,	,	interp
którzy	który	adj:pl:nom:m1:pos
stracili	stracić	praet:pl:m1:perf
zdrowie	zdrowie	subst:sg:acc:n
w	w	prep:loc:nwok
wypadku	wypadek	subst:sg:loc:m3
przy	przy	prep:loc
pracy	praca	subst:sg:loc:f
lub	lub	conj
wskutek	wskutek	prep:gen
choroby	choroba	subst:sg:gen:f
zawodowej	zawodowy	adj:sg:gen:f:pos
,	,	interp
powinni	powinien	winien:pl:m1:imperf
również	również	qub
dodatek	dodatek	subst:sg:acc:m3
ten	ten	adj:sg:acc:m3:pos
otrzymywać	otrzymywać	inf:imperf
,	,	interp
jeżeli	jeżeli	comp
oczywiście	oczywiście	qub
zostali	zostać	praet:pl:m1:perf
odznaczeni	odznaczyć	ppas:pl:nom:m1:perf:aff
odznaczeniem	odznaczenie	subst:sg:inst:n
,	,	interp
z	z	prep:inst:nwok
którym	który	adj:sg:inst:n:pos
dodatek	dodatek	subst:sg:nom:m3
ten	ten	adj:sg:nom:m3:pos
jest	być	fin:sg:ter:imperf
związany	związać	adj:sg:nom:m3:pos
.	.	interp
Okoliczność	okoliczność	subst:sg:nom:f
natomiast	natomiast	conj
,	,	interp
czy	czy	qub
wnioskodawca	wnioskodawca	subst:sg:nom:m1
rzeczywiście	rzeczywiście	adv:pos
pracuje	pracować	fin:sg:ter:imperf
w	w	prep:loc:nwok
warunkach	warunki	subst:pl:loc:n
szkodliwych	szkodliwy	adj:pl:loc:n:pos
dla	dla	prep:gen
zdrowia	zdrowie	subst:sg:gen:n
,	,	interp
jest	być	fin:sg:ter:imperf
bez	bez	prep:gen:nwok
znaczenia	znaczenie	subst:sg:gen:n
prawnego	prawny	adj:sg:gen:n:pos
.	.	interp
Nie	nie	qub
każdy	każdy	adj:sg:nom:m1:pos
bowiem	bowiem	comp
,	,	interp
kto	kto	subst:sg:nom:m1
jest	być	fin:sg:ter:imperf
zatrudniony	zatrudnić	ppas:sg:nom:m1:perf:aff
w	w	prep:loc:nwok
takich	taki	adj:pl:loc:n:pos
warunkach	warunki	subst:pl:loc:n
,	,	interp
korzysta	korzystać	fin:sg:ter:imperf
ze	z	prep:gen:wok
skróconego	skrócić	ppas:sg:gen:m3:perf:aff
czasu	czas	subst:sg:gen:m3
pracy	praca	subst:sg:gen:f
,	,	interp
a	a	conj
tylko	tylko	qub
ten	ten	adj:sg:nom:m1:pos
,	,	interp
którego	który	adj:sg:acc:m1:pos
do	do	prep:gen
skróconego	skrócić	ppas:sg:gen:m3:perf:aff
czasu	czas	subst:sg:gen:m3
pracy	praca	subst:sg:gen:f
uprawniają	uprawniać	fin:pl:ter:imperf
odpowiednie	odpowiedni	adj:pl:nom:m3:pos
przepisy	przepis	subst:pl:nom:m3
.	.	interp
Organizacja	organizacja	subst:sg:nom:f
życia	życie	subst:sg:gen:n
populacji	populacja	subst:sg:gen:f
starczej	starczy	adj:sg:gen:f:pos
jest	być	fin:sg:ter:imperf
dopiero	dopiero	qub
w	w	prep:loc:nwok
zalążku	zalążek	subst:sg:loc:m3
;	;	interp
z	z	prep:inst:nwok
ludźmi	człowiek	subst:pl:inst:m1
nie	nie	qub
opuszczającymi	opuszczać	pact:pl:inst:m1:imperf:aff
mieszkania	mieszkanie	subst:sg:gen:n
,	,	interp
którym	który	adj:pl:dat:m1:pos
najtrudniej	trudno	adv:sup
przychodzi	przychodzić	fin:sg:ter:imperf
ułożyć	ułożyć	inf:perf
sobie	siebie	siebie:dat
życie	życie	subst:sg:acc:n
i	i	conj
którzy	który	adj:pl:nom:m1:pos
najbardziej	bardzo	adv:sup
potrzebują	potrzebować	fin:pl:ter:imperf
zainteresowania	zainteresowanie	subst:sg:gen:n
,	,	interp
nie	nie	qub
ma	mieć	fin:sg:ter:imperf
kontaktu	kontakt	subst:sg:gen:m3
poza	poza	prep:inst
bardzo	bardzo	adv:pos
słabo	słabo	adv:pos
jeszcze	jeszcze	qub
rozwiniętymi	rozwinięty	adj:pl:inst:f:pos
usługami	usługa	subst:pl:inst:f
pielęgnacyjnymi	pielęgnacyjny	adj:pl:inst:f:pos
sióstr	siostra	subst:pl:gen:f
PCK	PCK	subst:sg:gen:m3
.	.	interp
Badani	badany	subst:pl:nom:m1
utrzymują	utrzymywać	fin:pl:ter:imperf
bliskie	bliski	adj:pl:acc:m3:pos
kontakty	kontakt	subst:pl:acc:m3
z	z	prep:inst:nwok
czterokrotnie	czterokrotnie	adv:pos
mniejszą	mały	adj:sg:inst:f:com
liczbą	liczba	subst:sg:inst:f
przyjaciół	przyjaciel	subst:pl:gen:m1
niż	niż	conj
krewnych	krewny	subst:pl:gen:m1
.	.	interp
Wśród	wśród	prep:gen
osób	osoba	subst:pl:gen:f
zaprzyjaźnionych	zaprzyjaźniony	adj:pl:gen:f:pos
absolutną	absolutny	adj:sg:acc:f:pos
przewagę	przewaga	subst:sg:acc:f
(	(	interp
80	80	num:pl:nom:m3:congr
-	-	interp
90	90	num:pl:nom:m3:congr
%	%	interp
)	)	interp
mają	mieć	fin:pl:ter:imperf
ludzie	człowiek	subst:pl:nom:m1
tej	ten	adj:sg:gen:f:pos
samej	sam	adj:sg:gen:f:pos
płci	płeć	subst:sg:gen:f
i	i	conj
na	na	prep:acc
ogół	ogół	subst:sg:acc:m3
również	również	qub
w	w	prep:loc:nwok
starszym	stary	adj:sg:loc:m3:com
wieku	wiek	subst:sg:loc:m3
(	(	interp
80	80	num:pl:nom:m3:congr
%	%	interp
)	)	interp
,	,	interp
co	co	subst:sg:nom:n
jest	być	fin:sg:ter:imperf
dla	dla	prep:gen
respondentów	respondent	subst:pl:gen:m1
bardzo	bardzo	adv:pos
niekorzystne	niekorzystny	adj:sg:nom:n:pos
;	;	interp
w	w	prep:acc:nwok
miarę	miara	subst:sg:acc:f
upływu	upływ	subst:sg:gen:m3
lat	rok	subst:pl:gen:m3
dawne	dawny	adj:pl:nom:m3:pos
kontakty	kontakt	subst:pl:nom:m3
słabną	słabnąć	fin:pl:ter:imperf
lub	lub	conj
przestają	przestawać	fin:pl:ter:imperf
istnieć	istnieć	inf:imperf
,	,	interp
a	a	conj
nowe	nowy	adj:pl:nom:m3:pos
nie	nie	qub
są	być	fin:pl:ter:imperf
nawiązywane	nawiązywać	ppas:pl:nom:m3:imperf:aff
.	.	interp
Prawie	prawie	qub
połowa	połowa	subst:sg:nom:f
respondentów	respondent	subst:pl:gen:m1
(	(	interp
45	45	num:pl:nom:m3:congr
%	%	interp
)	)	interp
nie	nie	qub
ma	mieć	fin:sg:ter:imperf
w	w	prep:loc:nwok
ogóle	ogół	subst:sg:loc:m3
przyjaciół	przyjaciel	subst:pl:gen:m1
.	.	interp
Powyższy	powyższy	adj:sg:nom:m3:pos
schemat	schemat	subst:sg:nom:m3
,	,	interp
będący	być	pact:sg:nom:m3:imperf:aff
niewątpliwie	niewątpliwie	adv:pos
znacznym	znaczny	adj:sg:inst:n:pos
uproszczeniem	uprościć	ger:sg:inst:n:perf:aff
rzeczywistych	rzeczywisty	adj:pl:gen:f:pos
relacji	relacja	subst:pl:gen:f
,	,	interp
może	móc	fin:sg:ter:imperf
posłużyć	posłużyć	inf:perf
jako	jako	conj
uzupełnienie	uzupełnienie	subst:sg:nom:n
koncepcji	koncepcja	subst:sg:gen:f
podsystemów	podsystem	subst:pl:gen:m3
uczestnictwa	uczestnictwo	subst:sg:gen:n
omówionych	omówić	ppas:pl:gen:m3:perf:aff
w	w	prep:loc:nwok
poprzednim	poprzedni	adj:sg:loc:m3:pos
rozdziale	rozdział	subst:sg:loc:m3
.	.	interp
Przy	przy	prep:loc
jego	on	ppron3:sg:gen:m3:ter:akc:npraep
pomocy	pomoc	subst:sg:loc:f
można	można	pred
obrazować	obrazować	inf:imperf
wpływ	wpływ	subst:sg:acc:m3
poszczególnych	poszczególny	adj:pl:gen:m3:pos
czynników	czynnik	subst:pl:gen:m3
absencji	absencja	subst:sg:gen:f
.	.	interp
Okazuje	okazywać	fin:sg:ter:imperf
się	się	qub
przy	przy	prep:loc
tym	to	subst:sg:loc:n
,	,	interp
że	że	comp
pewne	pewien	adj:pl:nom:m3:pos
czynniki	czynnik	subst:pl:nom:m3
mogą	móc	fin:pl:ter:imperf
realizować	realizować	inf:imperf
swój	swój	adj:sg:acc:m3:pos
wpływ	wpływ	subst:sg:acc:m3
na	na	prep:loc
kilku	kilka	num:pl:loc:m3:congr
etapach	etap	subst:pl:loc:m3
zachowań	zachowanie	subst:pl:gen:n
absencyjnych	absencyjny	adj:pl:gen:n:pos
,	,	interp
następujących	następować	pact:pl:gen:n:imperf:aff
po	po	prep:loc
sobie	siebie	siebie:loc
.	.	interp
Nie	nie	qub
podzielam	podzielać	fin:sg:pri:imperf
w	w	prep:loc:nwok
związku	związek	subst:sg:loc:m3
z	z	prep:inst:nwok
tym	to	subst:sg:inst:n
poglądu	pogląd	subst:sg:gen:m3
Autora	autor	subst:sg:gen:m1
glosy	glosa	subst:sg:gen:f
,	,	interp
że	że	comp
gdyby	gdyby	comp
ustawodawca	ustawodawca	subst:sg:nom:m1
utratę	utrata	subst:sg:acc:f
prawa	prawo	subst:sg:gen:n
do	do	prep:gen
urlopu	urlop	subst:sg:gen:m3
za	za	prep:acc
dany	dany	adj:sg:acc:m3:pos
rok	rok	subst:sg:acc:m3
przez	przez	prep:acc:nwok
pracownika	pracownik	subst:sg:acc:m1
wiązał	wiązać	praet:sg:m1:imperf
z	z	prep:inst:nwok
sytuacją	sytuacja	subst:sg:inst:f
,	,	interp
określoną	określić	ppas:sg:inst:f:perf:aff
w	w	prep:loc:nwok
art	artykuł	brev:pun
.	.	interp
156	156	adj:sg:loc:m3:pos
§	§	interp
1	1	adj:sg:nom:m3:pos
k	kodeks	brev:pun
.	.	interp
p	praca	brev:pun
.	.	interp
,	,	interp
znalazło	znaleźć	praet:sg:n:perf
by	by	qub
to	to	subst:sg:nom:n
"	"	interp
zapewne	zapewne	qub
"	"	interp
wyraźne	wyraźny	adj:sg:acc:n:pos
odbicie	odbicie	subst:sg:acc:n
w	w	prep:loc:nwok
tym	ten	adj:sg:loc:m3:pos
przepisie	przepis	subst:sg:loc:m3
.	.	interp
Na	na	prep:acc
przyjętą	przyjąć	ppas:sg:acc:f:perf:aff
definicję	definicja	subst:sg:acc:f
rodziny	rodzina	subst:sg:gen:f
niepełnej	niepełny	adj:sg:gen:f:pos
wpłynęły	wpłynąć	praet:pl:m3:perf
zarówno	zarówno	conj
względy	wzgląd	subst:pl:nom:m3
techniczne	techniczny	adj:pl:nom:m3:pos
,	,	interp
a	a	conj
więc	więc	conj
stosunkowa	stosunkowy	adj:sg:nom:f:pos
łatwość	łatwość	subst:sg:nom:f
wyodrębnienia	wyodrębnić	ger:sg:gen:n:perf:aff
spośród	spośród	prep:gen
pracowników	pracownik	subst:pl:gen:m1
zakładów	zakład	subst:pl:gen:m3
takich	taki	adj:pl:gen:m1:pos
,	,	interp
którzy	który	adj:pl:nom:m1:pos
samotnie	samotnie	adv:pos
wychowują	wychowywać	fin:pl:ter:imperf
dziecko	dziecko	subst:sg:acc:n
lub	lub	conj
dzieci	dziecko	subst:pl:acc:n
,	,	interp
jak	jak	conj
i	i	conj
przede	przed	prep:inst:wok
wszystkim	wszystko	subst:sg:inst:n
cel	cel	subst:sg:nom:m3
badania	badanie	subst:sg:gen:n
.	.	interp
Celem	cel	subst:sg:inst:m3
badania	badanie	subst:sg:gen:n
było	być	praet:sg:n:imperf
bowiem	bowiem	comp
ustalenie	ustalić	ger:sg:nom:n:perf:aff
potrzeb	potrzeba	subst:pl:gen:f
rodzin	rodzina	subst:pl:gen:f
niepełnych	niepełny	adj:pl:gen:f:pos
służące	służyć	pact:sg:nom:n:imperf:aff
zracjonalizowaniu	zracjonalizować	ger:sg:dat:n:perf:aff
zakładowej	zakładowy	adj:sg:gen:f:pos
polityki	polityka	subst:sg:gen:f
społecznej	społeczny	adj:sg:gen:f:pos
w	w	prep:loc:nwok
odniesieniu	odniesienie	subst:sg:loc:n
do	do	prep:gen
rodzin	rodzina	subst:pl:gen:f
pracowniczych	pracowniczy	adj:pl:gen:f:pos
.	.	interp
Powszechnie	powszechnie	adv:pos
wiadomo	wiadomo	pred
,	,	interp
że	że	comp
jednym	jeden	adj:sg:inst:m3:pos
z	z	prep:gen:nwok
czynników	czynnik	subst:pl:gen:m3
warunkujących	warunkować	pact:pl:gen:m3:imperf:aff
sumienne	sumienny	adj:sg:acc:n:pos
i	i	conj
staranne	staranny	adj:sg:acc:n:pos
wykonywanie	wykonywać	ger:sg:acc:n:imperf:aff
obowiązków	obowiązek	subst:pl:gen:m3
przez	przez	prep:acc:nwok
pracowników	pracownik	subst:pl:acc:m1
jest	być	fin:sg:ter:imperf
właśnie	właśnie	qub
ich	on	ppron3:pl:gen:m1:ter:akc:npraep
sytuacja	sytuacja	subst:sg:nom:f
rodzinna	rodzinny	adj:sg:nom:f:pos
.	.	interp
Celem	cel	subst:sg:inst:m3
badania	badanie	subst:sg:gen:n
było	być	praet:sg:n:imperf
ERROR :		:interp
określenie	określić	ger:sg:nom:n:perf:aff
zróżnicowania	zróżnicowanie	subst:sg:gen:n
potrzeb	potrzeba	subst:pl:gen:f
zależnie	zależnie	adv:pos
od	od	prep:gen:nwok
cech	cecha	subst:pl:gen:f
demograficzno	demograficzny	adja
-	-	interp
społecznych	społeczny	adj:pl:gen:f:pos
ankietowanych	ankietowany	subst:pl:gen:m1
,	,	interp
stwierdzenie	stwierdzić	ger:sg:nom:n:perf:aff
zakresu	zakres	subst:sg:gen:m3
pomocy	pomoc	subst:sg:gen:f
otrzymywanej	otrzymywać	ppas:sg:gen:f:imperf:aff
obecnie	obecnie	adv:pos
przez	przez	prep:acc:nwok
respondentów	respondent	subst:pl:acc:m1
od	od	prep:gen:nwok
osób	osoba	subst:pl:gen:f
i	i	conj
instytucji	instytucja	subst:pl:gen:f
,	,	interp
wyodrębnienie	wyodrębnić	ger:sg:nom:n:perf:aff
kategorii	kategoria	subst:sg:gen:f
ludzi	człowiek	subst:pl:gen:m1
starszych	stary	adj:pl:gen:m1:com
najbardziej	bardzo	adv:sup
potrzebujących	potrzebować	pact:pl:gen:m1:imperf:aff
opieki	opieka	subst:sg:gen:f
,	,	interp
a	a	conj
także	także	conj
określenie	określić	ger:sg:nom:n:perf:aff
preferencji	preferencja	subst:pl:gen:f
tych	ten	adj:pl:gen:f:pos
osób	osoba	subst:pl:gen:f
w	w	prep:loc:nwok
zakresie	zakres	subst:sg:loc:m3
postulowanych	postulować	ppas:pl:gen:f:imperf:aff
przez	przez	prep:acc:nwok
nich	on	ppron3:pl:acc:m1:ter:akc:praep
określonych	określony	adj:pl:gen:f:pos
form	forma	subst:pl:gen:f
pomocy	pomoc	subst:sg:gen:f
.	.	interp
Tylko	tylko	qub
4	4	num:pl:nom:f:congr
/	/	interp
5	5	adj:pl:nom:f:pos
badanych	badany	subst:pl:gen:m1
mieszka	mieszkać	fin:sg:ter:imperf
w	w	prep:loc:nwok
lokalu	lokal	subst:sg:loc:m3
samodzielnym	samodzielny	adj:sg:loc:m3:pos
;	;	interp
pozostali	pozostały	adj:pl:nom:m1:pos
mają	mieć	fin:pl:ter:imperf
nakaz	nakaz	subst:sg:acc:m3
kwaterunkowy	kwaterunkowy	adj:sg:acc:m3:pos
na	na	prep:acc
część	część	subst:sg:acc:f
mieszkania	mieszkanie	subst:sg:gen:n
bądź	bądź	conj
odnajmują	odnajmować	fin:pl:ter:imperf
pokój	pokój	subst:sg:acc:m3
sublokatorski	sublokatorski	adj:sg:acc:m3:pos
.	.	interp
Ludzie	człowiek	subst:pl:nom:m1
mieszkający	mieszkać	pact:pl:nom:m1:imperf:aff
razem	razem	adv
z	z	prep:inst:nwok
obcymi	obcy	subst:pl:inst:m1
to	to	pred
najczęściej	często	adv:sup
osoby	osoba	subst:pl:nom:f
o	o	prep:loc
niższym	niski	adj:sg:loc:m3:com
poziomie	poziom	subst:sg:loc:m3
wykształcenia	wykształcenie	subst:sg:gen:n
.	.	interp
Spośród	spośród	prep:gen
nich	on	ppron3:pl:gen:m1:ter:akc:praep
co	co	qub
czwarty	czwarty	adj:sg:nom:m1:pos
jest	być	fin:sg:ter:imperf
narażony	narazić	ppas:sg:nom:m1:perf:aff
na	na	prep:acc
stałe	stały	adj:pl:acc:f:pos
lub	lub	conj
sporadyczne	sporadyczny	adj:pl:acc:f:pos
przykrości	przykrość	subst:pl:acc:f
;	;	interp
ludzie	człowiek	subst:pl:nom:m1
ci	ten	adj:pl:nom:m1:pos
zapobiegają	zapobiegać	fin:pl:ter:imperf
konfliktom	konflikt	subst:pl:dat:m3
przez	przez	prep:acc:nwok
ograniczenie	ograniczyć	ger:sg:acc:n:perf:aff
do	do	prep:gen
minimum	minimum	subst:sg:gen:n
korzystania	korzystać	ger:sg:gen:n:imperf:aff
ze	z	prep:gen:wok
wspólnych	wspólny	adj:pl:gen:n:pos
pomieszczeń	pomieszczenie	subst:pl:gen:n
.	.	interp
