Zastanawiając	zastanawiać	pcon:imperf
się	się	qub
nad	nad	prep:inst:nwok
szansami	szansa	subst:pl:inst:f
powstania	powstanie	subst:sg:gen:n
majowego	majowy	adj:sg:gen:n:pos
na	na	prep:loc
Ukrainie	Ukraina	subst:sg:loc:f
Prawobrzeżnej	prawobrzeżny	adj:sg:loc:f:pos
w	w	prep:loc:nwok
1863	1863	adj:sg:loc:m3:pos
r	rok	brev:pun
.	.	interp
,	,	interp
trudno	trudno	adv:pos
nie	nie	qub
postawić	postawić	inf:perf
kilku	kilka	num:pl:gen:n:congr
zasadniczych	zasadniczy	adj:pl:gen:n:pos
pytań	pytanie	subst:pl:gen:n
ERROR :		:interp
1	1	adj:sg:nom:n:pos
)	)	interp
w	w	prep:loc:nwok
jakim	jaki	adj:sg:loc:m3:pos
stopniu	stopień	subst:sg:loc:m3
istniejące	istnieć	pact:pl:nom:m3:imperf:aff
,	,	interp
silne	silny	adj:pl:nom:m3:pos
antagonizmy	antagonizm	subst:pl:nom:m3
społeczne	społeczny	adj:pl:nom:m3:pos
,	,	interp
narodowe	narodowy	adj:pl:nom:m3:pos
i	i	conj
wyznaniowe	wyznaniowy	adj:pl:nom:m3:pos
miały	mieć	praet:pl:m3:imperf
wpływ	wpływ	subst:sg:acc:m3
na	na	prep:acc
uczestnictwo	uczestnictwo	subst:sg:acc:n
w	w	prep:loc:nwok
powstaniu	powstanie	subst:sg:loc:n
?	?	interp
2	2	adj:sg:nom:n:pos
)	)	interp
kto	kto	subst:sg:nom:m1
był	być	praet:sg:m1:imperf
głównym	główny	adj:sg:inst:m3:pos
motorem	motor	subst:sg:inst:m3
napędowym	napędowy	adj:sg:inst:m3:pos
ruchu	ruch	subst:sg:gen:m3
narodowowyzwoleńczego	narodowowyzwoleńczy	adj:sg:gen:m3:pos
?	?	interp
3	3	adj:sg:nom:n:pos
)	)	interp
jakie	jaki	adj:pl:nom:m3:pos
były	być	praet:pl:m3:imperf
cele	cel	subst:pl:nom:m3
,	,	interp
dążenia	dążenie	subst:pl:nom:n
i	i	conj
skala	skala	subst:sg:nom:f
przygotowań	przygotowanie	subst:pl:gen:n
powstańczych	powstańczy	adj:pl:gen:n:pos
?	?	interp
