Ze	z	prep:gen:wok
swej	swój	adj:sg:gen:f:pos
strony	strona	subst:sg:gen:f
stacja	stacja	subst:sg:nom:f
krwiodawstwa	krwiodawstwo	subst:sg:gen:n
na	na	prep:acc
wszelkie	wszelki	adj:pl:acc:m3:pos
sposoby	sposób	subst:pl:acc:m3
stara	starać	fin:sg:ter:imperf
się	się	qub
nakłonić	nakłonić	inf:perf
do	do	prep:gen
oddawania	oddawać	ger:sg:gen:n:imperf:aff
krwi	krew	subst:sg:gen:f
,	,	interp
choćby	choćby	qub
tylko	tylko	qub
jednorazowego	jednorazowy	adj:sg:gen:n:pos
.	.	interp
Apele	apel	subst:pl:acc:m3
stacji	stacja	subst:sg:gen:f
mogą	móc	fin:pl:ter:imperf
przeczytać	przeczytać	inf:perf
m.in	między innymi	brev:pun
.	.	interp
pasażerowie	pasażer	subst:pl:nom:m1
podróżujący	podróżować	pact:sg:nom:m1:imperf:aff
taborem	tabor	subst:sg:inst:m3
MPK	MPK	subst:sg:gen:n
.	.	interp
Stacja	stacja	subst:sg:nom:f
czynna	czynny	adj:sg:nom:f:pos
jest	być	fin:sg:ter:imperf
codziennie	codziennie	adv:pos
od	od	prep:gen:nwok
7	7	adj:sg:gen:f:pos
.	.	interp
00	00	num:pl:nom:f:rec
do	do	prep:gen
14	14	adj:sg:gen:f:pos
.	.	interp
30	30	num:pl:nom:f:rec
(	(	interp
rejestracja	rejestracja	subst:sg:nom:f
)	)	interp
,	,	interp
również	również	qub
w	w	prep:acc:nwok
soboty	sobota	subst:pl:acc:f
od	od	prep:gen:nwok
7	7	adj:sg:gen:f:pos
.	.	interp
00	00	num:pl:nom:f:rec
do	do	prep:gen
11	11	adj:sg:gen:f:pos
.	.	interp
00	00	num:pl:nom:f:rec
.	.	interp
