Zakończyły	zakończyć	praet:pl:f:perf
się	się	qub
ligowe	ligowy	adj:pl:nom:f:pos
rozgrywki	rozgrywka	subst:pl:nom:f
drużynowych	drużynowy	adj:pl:gen:n:pos
mistrzostw	mistrzostwa	subst:pl:gen:n
Polski	Polska	subst:sg:gen:f
w	w	prep:loc:nwok
zapasach	zapasy	subst:pl:loc:n
.	.	interp
W	w	prep:loc:nwok
stylu	styl	subst:sg:loc:m3
klasycznym	klasyczny	adj:sg:loc:m3:pos
triumfował	triumfować	praet:sg:m3:imperf
Śląsk	Śląsk	subst:sg:nom:m3
Wrocław	Wrocław	subst:sg:nom:m3
przed	przed	prep:inst:nwok
PTC	PTC	subst:sg:inst:n
Pabianice	Pabianice	subst:pl:nom:n
i	i	conj
MOSiR-em	MOSiR	subst:sg:inst:m3
Olimpem	Olimp	subst:sg:inst:m3
Kostrzyn	Kostrzyn	subst:sg:nom:m3
.	.	interp
W	w	prep:loc:nwok
stylu	styl	subst:sg:loc:m3
wolnym	wolny	adj:sg:loc:m3:pos
zwyciężył	zwyciężyć	praet:sg:m3:perf
AKS	AKS	subst:sg:nom:m3
Bialogard	Białogard	subst:sg:nom:m3
przed	przed	prep:inst:nwok
ZKS	ZKS	subst:sg:inst:m3
Brokiem	Brok	subst:sg:inst:m2
Koszalin	Koszalin	subst:sg:nom:m3
i	i	conj
Górnikiem	Górnik	subst:sg:inst:m2
Łęczna	Łęczna	subst:sg:nom:f
.	.	interp
