Rada	rada	subst:sg:nom:f
Ministrów	minister	subst:pl:gen:m1
w	w	prep:loc:nwok
ciągu	ciąg	subst:sg:loc:m3
5	5	num:pl:gen:m3:congr
miesięcy	miesiąc	subst:pl:gen:m3
od	od	prep:gen:nwok
zakończenia	zakończenie	subst:sg:gen:n
roku	rok	subst:sg:gen:m3
budżetowego	budżetowy	adj:sg:gen:m3:pos
przedkłada	przedkładać	fin:sg:ter:imperf
Sejmowi	sejm	subst:sg:dat:m3
sprawozdanie	sprawozdanie	subst:sg:acc:n
z	z	prep:gen:nwok
wykonania	wykonać	ger:sg:gen:n:perf:aff
ustawy	ustawa	subst:sg:gen:f
budżetowej	budżetowy	adj:sg:gen:f:pos
wraz	wraz	adv
z	z	prep:inst:nwok
informacją	informacja	subst:sg:inst:f
o	o	prep:loc
stanie	stan	subst:sg:loc:m3
zadłużenia	zadłużenie	subst:sg:gen:n
państwa	państwo	subst:sg:gen:n
.	.	interp
Sejm	sejm	subst:sg:nom:m3
rozpatruje	rozpatrywać	fin:sg:ter:imperf
przedłożone	przedłożyć	ppas:sg:acc:n:perf:aff
sprawozdanie	sprawozdanie	subst:sg:acc:n
i	i	conj
po	po	prep:loc
zapoznaniu	zapoznać	ger:sg:loc:n:perf:aff
się	się	qub
z	z	prep:inst:nwok
opinią	opinia	subst:sg:inst:f
Najwyższej	wysoki	adj:sg:gen:f:sup
Izby	izba	subst:sg:gen:f
Kontroli	kontrola	subst:sg:gen:f
podejmuje	podejmować	fin:sg:ter:imperf
,	,	interp
w	w	prep:loc:nwok
ciągu	ciąg	subst:sg:loc:m3
90	90	num:pl:gen:m3:congr
dni	dzień	subst:pl:gen:m3
od	od	prep:gen:nwok
dnia	dzień	subst:sg:gen:m3
przedłożenia	przedłożyć	ger:sg:gen:n:perf:aff
Sejmowi	sejm	subst:sg:dat:m3
sprawozdania	sprawozdanie	subst:sg:gen:n
,	,	interp
uchwałę	uchwała	subst:sg:acc:f
o	o	prep:loc
udzieleniu	udzielić	ger:sg:loc:n:perf:aff
lub	lub	conj
o	o	prep:loc
odmowie	odmowa	subst:sg:loc:f
udzielenia	udzielić	ger:sg:gen:n:perf:aff
Radzie	rada	subst:sg:dat:f
Ministrów	minister	subst:pl:gen:m1
absolutorium	absolutorium	subst:sg:gen:n
.	.	interp
