Wrocławska	wrocławski	adj:sg:nom:f:pos
klinika	klinika	subst:sg:nom:f
Akademii	akademia	subst:sg:gen:f
Medycznej	medyczny	adj:sg:gen:f:pos
jako	jako	conj
pierwsza	pierwszy	adj:sg:nom:f:pos
w	w	prep:loc:nwok
Polsce	Polska	subst:sg:loc:f
zacznie	zacząć	fin:sg:ter:perf
niedługo	niedługo	adv:pos
stosować	stosować	inf:imperf
terapię	terapia	subst:sg:acc:f
genową	genowy	adj:sg:acc:f:pos
.	.	interp
Klinika	klinika	subst:sg:nom:f
Onkologii	onkologia	subst:sg:gen:f
i	i	conj
Hematologii	hematologia	subst:sg:gen:f
Dziecięcej	dziecięcy	adj:sg:gen:f:pos
AM	AM	subst:sg:gen:f
unowocześniła	unowocześnić	praet:sg:f:perf
i	i	conj
powiększyła	powiększyć	praet:sg:f:perf
swój	swój	adj:sg:acc:m3:pos
Dziecięcy	dziecięcy	adj:sg:acc:m3:pos
Oddział	oddział	subst:sg:acc:m3
Przeszczepiania	przeszczepiać	ger:sg:gen:n:imperf:aff
Szpiku	szpik	subst:sg:gen:m3
Kostnego	kostny	adj:sg:gen:m3:pos
i	i	conj
Terapii	terapia	subst:sg:gen:f
Genowej	genowy	adj:sg:gen:f:pos
.	.	interp
Obecnie	obecnie	adv:pos
ma	mieć	fin:sg:ter:imperf
największy	duży	adj:sg:acc:m3:sup
oddział	oddział	subst:sg:acc:m3
w	w	prep:loc:nwok
Polsce	Polska	subst:sg:loc:f
,	,	interp
który	który	adj:sg:nom:m3:pos
liczy	liczyć	fin:sg:ter:imperf
12	12	num:pl:acc:n:rec
łóżek	łóżko	subst:pl:gen:n
.	.	interp
