Na	na	prep:acc
przejście	przejście	subst:sg:acc:n
drogowe	drogowy	adj:sg:acc:n:pos
w	w	prep:loc:nwok
Budzisku	Budzisko	subst:sg:loc:n
około	około	prep:gen
6	6	adj:sg:gen:f:pos
.	.	interp
00	00	num:pl:nom:f:rec
rano	rano	adv:pos
podjechał	podjechać	praet:sg:m3:perf
specjalistyczny	specjalistyczny	adj:sg:nom:m3:pos
autobus	autobus	subst:sg:nom:m3
z	z	prep:inst:nwok
przyczepą	przyczepa	subst:sg:inst:f
-	-	interp
warsztatem	warsztat	subst:sg:inst:m3
na	na	prep:acc
motocykle	motocykl	subst:pl:acc:m3
.	.	interp
Pojazd	pojazd	subst:sg:acc:m3
poddano	poddać	imps:perf
szczegółowej	szczegółowy	adj:sg:dat:f:pos
kontroli	kontrola	subst:sg:dat:f
.	.	interp
W	w	prep:loc:nwok
wielu	wiele	num:pl:loc:f:congr
różnych	różny	adj:pl:loc:f:pos
skrytkach	skrytka	subst:pl:loc:f
,	,	interp
w	w	prep:loc:nwok
podwójnych	podwójny	adj:pl:loc:f:pos
ściankach	ścianka	subst:pl:loc:f
,	,	interp
siedzeniach	siedzenie	subst:pl:loc:n
i	i	conj
łóżkach	łóżko	subst:pl:loc:n
ukryte	ukryć	ppas:pl:nom:f:perf:aff
były	być	praet:pl:f:imperf
paczki	paczka	subst:pl:nom:f
papierosów	papieros	subst:pl:gen:m2
.	.	interp
W	w	prep:loc:nwok
sumie	suma	subst:sg:loc:f
celnicy	celnik	subst:pl:nom:m1
znaleźli	znaleźć	praet:pl:m1:perf
25	25	num:pl:acc:m3:rec
tys	tysiąc	brev:pun
.	.	interp
paczek	paczka	subst:pl:gen:f
papierosów	papieros	subst:pl:gen:m2
West	West	subst:sg:nom:m3
o	o	prep:loc
wartości	wartość	subst:sg:loc:f
112,5	112,5	num:pl:gen:m3:congr
tys	tysiąc	brev:pun
.	.	interp
zł	złoty	brev:npun
.	.	interp
