Na	na	prep:acc
wniosek	wniosek	subst:sg:acc:m3
rządu	rząd	subst:sg:gen:m3
wejście	wejść	ger:sg:acc:n:perf:aff
w	w	prep:acc:nwok
życie	życie	subst:sg:acc:n
reformy	reforma	subst:sg:gen:f
przesunięto	przesunąć	imps:perf
o	o	prep:acc
cały	cały	adj:sg:acc:m3:pos
kwartał	kwartał	subst:sg:acc:m3
(	(	interp
pierwsze	pierwszy	adj:pl:nom:f:pos
składki	składka	subst:pl:nom:f
do	do	prep:gen
funduszy	fundusz	subst:pl:gen:m3
emerytalnych	emerytalny	adj:pl:gen:m3:pos
popłynęły	popłynąć	praet:pl:f:perf
nie	nie	qub
w	w	prep:loc:nwok
styczniu	styczeń	subst:sg:loc:m3
,	,	interp
ale	ale	conj
maju	maj	subst:sg:loc:m3
1999	1999	adj:sg:gen:m3:pos
roku	rok	subst:sg:gen:m3
)	)	interp
.	.	interp
-	-	interp
We	w	prep:loc:wok
wnioskach	wniosek	subst:pl:loc:m3
NIK	NIK	subst:sg:gen:f
nie	nie	qub
ma	mieć	fin:sg:ter:imperf
o	o	prep:loc
tym	to	subst:sg:loc:n
ani	ani	qub
słowa	słowo	subst:sg:gen:n
-	-	interp
przypomina	przypominać	fin:sg:ter:imperf
wiceminister	wiceminister	subst:sg:nom:m1
pracy	praca	subst:sg:gen:f
.	.	interp
